Datum;BundeslandID;Name;Testungen;TestungenPCR;TestungenAntigen;Fälle
2021;1;Burgenland;638575;155435;483140;17797
2021;2;Kärnten;675557;217933;457624;18828
2021;3;Niederösterreich;3400756;1141984;2258772;94781
2021;4;Oberösterreich;2162517;546777;1615740;60271
2021;5;Salzburg;823353;274598;548755;22947
2021;6;Steiermark;1758065;503274;1254791;48998
2021;7;Tirol;1521757;579890;941867;42412
2021;8;Vorarlberg;825612;298572;527040;23010
2021;9;Wien;3197153;1677203;1519950;89107
2021;10;Österreich;15003345;5395666;9607679;418152
2021;1;Burgenland;645941;155933;490008;18003
2021;2;Kärnten;704089;219190;484899;19623
2021;3;Niederösterreich;3471229;1147138;2324091;96745
2021;4;Oberösterreich;2241062;548394;1692668;62460
2021;5;Salzburg;847370;275923;571447;23617
2021;6;Steiermark;1801508;505525;1295983;50209
2021;7;Tirol;1539898;583765;956133;42918
2021;8;Vorarlberg;842170;299159;543011;23472
2021;9;Wien;3264872;1721257;1543615;90994
2021;10;Österreich;15358139;5456284;9901855;428040
2021;1;Burgenland;656824;156596;500228;18306
2021;2;Kärnten;708065;220503;487562;19734
2021;3;Niederösterreich;3525810;1153997;2371813;98266
2021;4;Oberösterreich;2276421;550375;1726046;63445
2021;5;Salzburg;859248;277381;581867;23948
2021;6;Steiermark;1852502;508297;1344205;51630
2021;7;Tirol;1552380;588092;964288;43266
2021;8;Vorarlberg;855489;300574;554915;23843
2021;9;Wien;3316131;1751657;1564474;92423
2021;10;Österreich;15602870;5507472;10095398;434861
2021;1;Burgenland;665306;157400;507906;18542
2021;2;Kärnten;709254;221614;487640;19767
2021;3;Niederösterreich;3580743;1164883;2415860;99797
2021;4;Oberösterreich;2332134;552588;1779546;64998
2021;5;Salzburg;871522;278819;592703;24290
2021;6;Steiermark;1899187;509514;1389673;52931
2021;7;Tirol;1569811;591254;978557;43752
2021;8;Vorarlberg;868793;301846;566947;24214
2021;9;Wien;3367370;1779673;1587697;93851
2021;10;Österreich;15864120;5557591;10306529;442142
2021;1;Burgenland;677110;158537;518573;18871
2021;2;Kärnten;710375;222676;487699;19799
2021;3;Niederösterreich;3631722;1175337;2456385;101218
2021;4;Oberösterreich;2368282;554878;1813404;66005
2021;5;Salzburg;914767;280410;634357;25495
2021;6;Steiermark;1929023;512435;1416588;53763
2021;7;Tirol;1587729;594508;993221;44251
2021;8;Vorarlberg;882629;302984;579645;24599
2021;9;Wien;3421978;1808879;1613099;95373
2021;10;Österreich;16123615;5610644;10512971;449375
2021;1;Burgenland;692887;159511;533376;19311
2021;2;Kärnten;711306;223558;487748;19825
2021;3;Niederösterreich;3693241;1186373;2506868;102933
2021;4;Oberösterreich;2407310;556843;1850467;67093
2021;5;Salzburg;931315;281493;649822;25956
2021;6;Steiermark;1966099;517914;1448185;54796
2021;7;Tirol;1604167;597648;1006519;44709
2021;8;Vorarlberg;896689;304480;592209;24991
2021;9;Wien;3471274;1829876;1641398;96746
2021;10;Österreich;16374288;5657696;10716592;456361
2021;1;Burgenland;694733;160380;534353;19363
2021;2;Kärnten;711909;224122;487787;19841
2021;3;Niederösterreich;3738592;1195621;2542971;104197
2021;4;Oberösterreich;2428659;558448;1870211;67688
2021;5;Salzburg;939879;282427;657452;26195
2021;6;Steiermark;1993544;520159;1473385;55561
2021;7;Tirol;1619308;599943;1019365;45131
2021;8;Vorarlberg;904537;305649;598888;25210
2021;9;Wien;3501971;1836430;1665541;97602
2021;10;Österreich;16533132;5683179;10849953;460788
2021;1;Burgenland;705722;160835;544887;19669
2021;2;Kärnten;713785;225967;487818;19894
2021;3;Niederösterreich;3765805;1203769;2562036;104955
2021;4;Oberösterreich;2452634;560051;1892583;68356
2021;5;Salzburg;947009;283512;663497;26394
2021;6;Steiermark;1996501;523116;1473385;55644
2021;7;Tirol;1633325;602260;1031065;45522
2021;8;Vorarlberg;911122;306153;604969;25394
2021;9;Wien;3529309;1842699;1686610;98364
2021;10;Österreich;16655212;5708362;10946850;464191
2021;1;Burgenland;716398;161608;554790;19966
2021;2;Kärnten;763750;227722;536028;21286
2021;3;Niederösterreich;3824765;1209202;2615563;106598
2021;4;Oberösterreich;2517626;562396;1955230;70168
2021;5;Salzburg;982741;284782;697959;27390
2021;6;Steiermark;2066437;526879;1539558;57593
2021;7;Tirol;1645194;605377;1039817;45853
2021;8;Vorarlberg;926254;306739;619515;25815
2021;9;Wien;3607954;1893903;1714051;100556
2021;10;Österreich;17051119;5778608;11272511;475225
2021;1;Burgenland;725692;162864;562828;20225
2021;2;Kärnten;780153;228854;551299;21743
2021;3;Niederösterreich;3885068;1214172;2670896;108279
2021;4;Oberösterreich;2560979;564876;1996103;71376
2021;5;Salzburg;1001876;286638;715238;27923
2021;6;Steiermark;2117895;529564;1588331;59027
2021;7;Tirol;1656543;608527;1048016;46169
2021;8;Vorarlberg;940650;308199;632451;26216
2021;9;Wien;3660447;1924329;1736118;102019
2021;10;Österreich;17329303;5828023;11501280;482978
2021;1;Burgenland;735955;163979;571976;20512
2021;2;Kärnten;780828;229447;551381;21762
2021;3;Niederösterreich;3930268;1226953;2703315;109539
2021;4;Oberösterreich;2617695;567105;2050590;72957
2021;5;Salzburg;1023271;288373;734898;28519
2021;6;Steiermark;2145853;532499;1613354;59806
2021;7;Tirol;1669705;612427;1057278;46536
2021;8;Vorarlberg;953849;309421;644428;26584
2021;9;Wien;3691533;1948622;1742911;102885
2021;10;Österreich;17548957;5878826;11670131;489100
2021;1;Burgenland;745729;164996;580733;20784
2021;2;Kärnten;782016;230545;551471;21795
2021;3;Niederösterreich;4004202;1237497;2766705;111599
2021;4;Oberösterreich;2658827;569777;2089050;74103
2021;5;Salzburg;1042456;289875;752581;29054
2021;6;Steiermark;2174570;533535;1641035;60607
2021;7;Tirol;1762040;616766;1145274;49109
2021;8;Vorarlberg;968333;310843;657490;26988
2021;9;Wien;3768674;1982707;1785967;105035
2021;10;Österreich;17906847;5936541;11970306;499074
2021;1;Burgenland;765111;165863;599248;21324
2021;2;Kärnten;783011;231450;551561;21823
2021;3;Niederösterreich;4079284;1250051;2829233;113692
2021;4;Oberösterreich;2699892;572111;2127781;75248
2021;5;Salzburg;1065238;291240;773998;29689
2021;6;Steiermark;2215308;539493;1675815;61742
2021;7;Tirol;1780612;620933;1159679;49627
2021;8;Vorarlberg;982335;312309;670026;27378
2021;9;Wien;3807817;1994653;1813164;106126
2021;10;Österreich;18178608;5978103;12200505;506649
2021;1;Burgenland;772126;166899;605227;21520
2021;2;Kärnten;783426;231848;551578;21835
2021;3;Niederösterreich;4130698;1259580;2871118;115125
2021;4;Oberösterreich;2722516;574282;2148234;75878
2021;5;Salzburg;1075448;292294;783154;29973
2021;6;Steiermark;2243171;541719;1701452;62518
2021;7;Tirol;1794959;624658;1170301;50027
2021;8;Vorarlberg;990424;313553;676871;27604
2021;9;Wien;3833275;1999834;1833441;106836
2021;10;Österreich;18346043;6004667;12341376;511315
2021;1;Burgenland;778154;167469;610685;21688
2021;2;Kärnten;785396;233795;551601;21889
2021;3;Niederösterreich;4167187;1267556;2899631;116142
2021;4;Oberösterreich;2749652;576547;2173105;76634
2021;5;Salzburg;1077012;293760;783252;30017
2021;6;Steiermark;2247450;545998;1701452;62638
2021;7;Tirol;1811508;629138;1182370;50488
2021;8;Vorarlberg;998950;314260;684690;27841
2021;9;Wien;3869837;2005304;1864533;107855
2021;10;Österreich;18485146;6033827;12451319;515192
2021;1;Burgenland;790271;168495;621776;22025
2021;2;Kärnten;786786;235099;551687;21928
2021;3;Niederösterreich;4239419;1273437;2965982;118155
2021;4;Oberösterreich;2819376;578865;2240511;78578
2021;5;Salzburg;1102571;295314;807257;30729
2021;6;Steiermark;2345419;549514;1795905;65368
2021;7;Tirol;1826809;634117;1192692;50914
2021;8;Vorarlberg;1015789;314912;700877;28311
2021;9;Wien;3914427;2023848;1890579;109097
2021;10;Österreich;18840867;6073601;12767266;525106
2021;1;Burgenland;799358;169159;630199;22279
2021;2;Kärnten;870998;236238;634760;24275
2021;3;Niederösterreich;4307909;1280082;3027827;120064
2021;4;Oberösterreich;2851427;580588;2270839;79471
2021;5;Salzburg;1122193;297447;824746;31276
2021;6;Steiermark;2396525;551159;1845366;66793
2021;7;Tirol;1937323;640101;1297222;53994
2021;8;Vorarlberg;1033799;316342;717457;28813
2021;9;Wien;3957995;2045013;1912982;110312
2021;10;Österreich;19277527;6116129;13161398;537276
2021;1;Burgenland;809593;170019;639574;22564
2021;2;Kärnten;871799;237039;634760;24298
2021;3;Niederösterreich;4377441;1289028;3088413;122002
2021;4;Oberösterreich;2927953;583231;2344722;81604
2021;5;Salzburg;1142497;299314;843183;31842
2021;6;Steiermark;2426106;553683;1872423;67617
2021;7;Tirol;1953024;644858;1308166;54432
2021;8;Vorarlberg;1064740;331334;733406;29675
2021;9;Wien;4002957;2064415;1938542;111565
2021;10;Österreich;19576110;6172921;13403189;545598
2021;1;Burgenland;823041;170684;652357;22939
2021;2;Kärnten;872716;237799;634917;24323
2021;3;Niederösterreich;4452446;1303447;3148999;124092
2021;4;Oberösterreich;2958465;586089;2372376;82454
2021;5;Salzburg;1161332;300917;860415;32367
2021;6;Steiermark;2459841;558554;1901287;68557
2021;7;Tirol;1969077;649901;1319176;54879
2021;8;Vorarlberg;1098690;346817;751873;30621
2021;9;Wien;4049950;2084547;1965403;112874
2021;10;Österreich;19845558;6238755;13606803;553107
2021;1;Burgenland;835606;171866;663740;23289
2021;2;Kärnten;873766;238734;635032;24352
2021;3;Niederösterreich;4526483;1314724;3211759;126156
2021;4;Oberösterreich;2991505;588202;2403303;83375
2021;5;Salzburg;1184231;302701;881530;33005
2021;6;Steiermark;2493346;560759;1932587;69491
2021;7;Tirol;1986242;654513;1331729;55358
2021;8;Vorarlberg;1141970;363835;778135;31827
2021;9;Wien;4090443;2094724;1995719;114003
2021;10;Österreich;20123592;6290058;13833534;560856
2021;1;Burgenland;842503;173335;669168;23481
2021;2;Kärnten;874442;239351;635091;24371
2021;3;Niederösterreich;4579366;1326016;3253350;127630
2021;4;Oberösterreich;3014683;590380;2424303;84021
2021;5;Salzburg;1194163;303841;890322;33282
2021;6;Steiermark;2519857;562317;1957540;70230
2021;7;Tirol;1990374;658645;1331729;55473
2021;8;Vorarlberg;1182027;388614;793413;32944
2021;9;Wien;4119141;2099208;2019933;114803
2021;10;Österreich;20316556;6341707;13974849;566234
2021;1;Burgenland;849033;173957;675076;23663
2021;2;Kärnten;876391;241262;635129;24426
2021;3;Niederösterreich;4617906;1334355;3283551;128704
2021;4;Oberösterreich;3040358;591821;2448537;84737
2021;5;Salzburg;1195805;305136;890669;33328
2021;6;Steiermark;2521739;564199;1957540;70282
2021;7;Tirol;2019901;664006;1355895;56296
2021;8;Vorarlberg;1205686;404002;801684;33603
2021;9;Wien;4149666;2103661;2046005;115654
2021;10;Österreich;20476485;6382399;14094086;570692
2021;1;Burgenland;861558;174679;686879;24012
2021;2;Kärnten;929695;242218;687477;25911
2021;3;Niederösterreich;4694800;1339132;3355668;130847
2021;4;Oberösterreich;3088116;594780;2493336;86068
2021;5;Salzburg;1232030;306604;925426;34337
2021;6;Steiermark;2572266;568895;2003371;71691
2021;7;Tirol;2036946;670212;1366734;56771
2021;8;Vorarlberg;1234614;412368;822246;34409
2021;9;Wien;4196267;2122678;2073589;116952
2021;10;Österreich;20846292;6431566;14414726;580998
2021;1;Burgenland;872896;176121;696775;24328
2021;2;Kärnten;931134;243164;687970;25951
2021;3;Niederösterreich;4767494;1345120;3422374;132873
2021;4;Oberösterreich;3129752;598002;2531750;87228
2021;5;Salzburg;1252911;308780;944131;34919
2021;6;Steiermark;2625970;571728;2054242;73187
2021;7;Tirol;2053643;676228;1377415;57236
2021;8;Vorarlberg;1273158;431299;841859;35484
2021;9;Wien;4240176;2142874;2097302;118176
2021;10;Österreich;21147134;6493316;14653818;589383
2021;1;Burgenland;884164;177254;706910;24642
2021;2;Kärnten;932192;244147;688045;25981
2021;3;Niederösterreich;4855242;1358212;3497030;135318
2021;4;Oberösterreich;3184428;600979;2583449;88752
2021;5;Salzburg;1274885;311110;963775;35532
2021;6;Steiermark;2657562;575061;2082501;74068
2021;7;Tirol;2178261;681990;1496271;60709
2021;8;Vorarlberg;1313899;448492;865407;36619
2021;9;Wien;4284829;2171309;2113520;119421
2021;10;Österreich;21565462;6568554;14996908;601042
2021;1;Burgenland;899869;178434;721435;25080
2021;2;Kärnten;933153;245108;688045;26008
2021;3;Niederösterreich;4935497;1369259;3566238;137555
2021;4;Oberösterreich;3218056;604271;2613785;89689
2021;5;Salzburg;1295737;312885;982852;36113
2021;6;Steiermark;2663502;578496;2085006;74233
2021;7;Tirol;2194887;687087;1507800;61173
2021;8;Vorarlberg;1337430;472023;865407;37275
2021;9;Wien;4572963;2109209;2463754;127451
2021;10;Österreich;22051094;6556772;15494322;614577
2021;1;Burgenland;917549;179517;738032;25573
2021;2;Kärnten;934164;246030;688134;26036
2021;3;Niederösterreich;5025191;1381885;3643306;140055
2021;4;Oberösterreich;3252545;606881;2645664;90650
2021;5;Salzburg;1320211;314792;1005419;36795
2021;6;Steiermark;2698663;580529;2118134;75213
2021;7;Tirol;2211937;691486;1520451;61648
2021;8;Vorarlberg;1196919;195074;1001845;33359
2021;9;Wien;4637257;2137532;2499725;129243
2021;10;Österreich;22194436;6333726;15860710;618572
2021;1;Burgenland;927611;180786;746825;25853
2021;2;Kärnten;934873;246684;688189;26055
2021;3;Niederösterreich;5086477;1388767;3697710;141763
2021;4;Oberösterreich;3276807;609524;2667283;91327
2021;5;Salzburg;1331590;315978;1015612;37112
2021;6;Steiermark;2755439;582924;2172515;76796
2021;7;Tirol;2229212;696416;1532796;62129
2021;8;Vorarlberg;1218096;195695;1022401;33949
2021;9;Wien;4695367;2166958;2528409;130863
2021;10;Österreich;22455472;6383732;16071740;625847
2021;1;Burgenland;934721;181467;753254;26051
2021;2;Kärnten;936879;248648;688231;26111
2021;3;Niederösterreich;5124040;1396330;3727710;142810
2021;4;Oberösterreich;3301345;611519;2689826;92010
2021;5;Salzburg;1333746;317540;1016206;37172
2021;6;Steiermark;2758920;586405;2172515;76893
2021;7;Tirol;2247085;700979;1546106;62628
2021;8;Vorarlberg;1231825;196321;1035504;34332
2021;9;Wien;4741699;2182556;2559143;132154
2021;10;Österreich;22610260;6421765;16188495;630161
2021;1;Burgenland;949104;182242;766862;26452
2021;2;Kärnten;972454;249536;722918;27103
2021;3;Niederösterreich;5245241;1406001;3839240;146188
2021;4;Oberösterreich;3330249;614299;2715950;92816
2021;5;Salzburg;1368198;318944;1049254;38132
2021;6;Steiermark;2805617;589669;2215948;78194
2021;7;Tirol;2357712;706629;1651083;65711
2021;8;Vorarlberg;1260864;196870;1063994;35141
2021;9;Wien;4803867;2210079;2593788;133887
2021;10;Österreich;23093306;6474269;16619037;643624
2021;1;Burgenland;961060;183395;777665;26785
2021;2;Kärnten;990186;250521;739665;27597
2021;3;Niederösterreich;5335669;1414134;3921535;148708
2021;4;Oberösterreich;3367362;616943;2750419;93850
2021;5;Salzburg;1388828;320800;1068028;38707
2021;6;Steiermark;2862543;591326;2271217;79781
2021;7;Tirol;2376380;712407;1663973;66231
2021;8;Vorarlberg;1287471;197522;1089949;35883
2021;9;Wien;4882022;2256011;2626011;136065
2021;10;Österreich;23451521;6543059;16908462;653608
2021;1;Burgenland;974111;184672;789439;27149
2021;2;Kärnten;1020563;251514;769049;28444
2021;3;Niederösterreich;5413536;1424498;3989038;150878
2021;4;Oberösterreich;3419985;619390;2800595;95317
2021;5;Salzburg;1410452;322479;1087973;39310
2021;6;Steiermark;2894660;593978;2300682;80676
2021;7;Tirol;2395114;718645;1676469;66753
2021;8;Vorarlberg;1316236;198330;1117906;36684
2021;9;Wien;4960583;2302634;2657949;138254
2021;10;Österreich;23805240;6616140;17189100;663466
2021;1;Burgenland;982101;185541;796560;27372
2021;2;Kärnten;1021313;252215;769098;28465
2021;3;Niederösterreich;5481795;1436676;4045119;152781
2021;4;Oberösterreich;3453475;621864;2831611;96250
2021;5;Salzburg;1432749;324151;1108598;39932
2021;6;Steiermark;2934598;598097;2336501;81789
2021;7;Tirol;2413237;724157;1689080;67258
2021;8;Vorarlberg;1341643;199063;1142580;37392
2021;9;Wien;5025512;2344036;2681476;140064
2021;10;Österreich;24086423;6685800;17400623;671303
2021;1;Burgenland;1002217;186445;815772;27932
2021;2;Kärnten;1022572;253451;769121;28500
2021;3;Niederösterreich;5559735;1448714;4111021;154953
2021;4;Oberösterreich;3492403;624352;2868051;97335
2021;5;Salzburg;1461084;325658;1135426;40721
2021;6;Steiermark;2974104;599886;2374218;82890
2021;7;Tirol;2432393;729771;1702622;67792
2021;8;Vorarlberg;1377060;199918;1177142;38379
2021;9;Wien;5081347;2377323;2704024;141620
2021;10;Österreich;24402915;6745518;17657397;680124
2021;1;Burgenland;1008849;187349;821500;28117
2021;2;Kärnten;1023272;254140;769132;28519
2021;3;Niederösterreich;5627205;1459284;4167921;156834
2021;4;Oberösterreich;3528840;626331;2902509;98351
2021;5;Salzburg;1475805;326547;1149258;41132
2021;6;Steiermark;2994313;602646;2391667;83453
2021;7;Tirol;2452467;736297;1716170;68352
2021;8;Vorarlberg;1404146;200514;1203632;39134
2021;9;Wien;5132574;2407832;2724742;143048
2021;10;Österreich;24647471;6800940;17846531;686940
2021;1;Burgenland;1013451;188113;825338;28245
2021;2;Kärnten;1023928;254782;769146;28537
2021;3;Niederösterreich;5667003;1468744;4198259;157943
2021;4;Oberösterreich;3554759;628066;2926693;99073
2021;5;Salzburg;1477274;327327;1149947;41172
2021;6;Steiermark;2995783;604116;2391667;83494
2021;7;Tirol;2470439;740979;1729460;68853
2021;8;Vorarlberg;1407607;200919;1206688;39231
2021;9;Wien;5169561;2427382;2742179;144079
2021;10;Österreich;24779805;6840428;17939377;690628
2021;1;Burgenland;1022796;188567;834229;28506
2021;2;Kärnten;1024436;255285;769151;28552
2021;3;Niederösterreich;5724746;1475199;4249547;159552
2021;4;Oberösterreich;3596428;629818;2966610;100235
2021;5;Salzburg;1488972;328297;1160675;41499
2021;6;Steiermark;3020536;605935;2414601;84184
2021;7;Tirol;2491656;747621;1744035;69444
2021;8;Vorarlberg;1426164;201209;1224955;39748
2021;9;Wien;5203615;2435707;2767908;145028
2021;10;Österreich;24999349;6867638;18131711;696747
2021;1;Burgenland;1033403;189366;844037;28802
2021;2;Kärnten;1038815;256459;782356;28952
2021;3;Niederösterreich;5801219;1481130;4320089;161683
2021;4;Oberösterreich;3656302;631815;3024487;101903
2021;5;Salzburg;1530422;329902;1200520;42654
2021;6;Steiermark;3091240;609540;2481700;86155
2021;7;Tirol;2650259;753905;1896354;73864
2021;8;Vorarlberg;1458976;210354;1248622;40663
2021;9;Wien;5255361;2473660;2781701;146470
2021;10;Österreich;25515997;6936131;18579866;711146
2021;1;Burgenland;1047236;190519;856717;29187
2021;2;Kärnten;1072569;257448;815121;29893
2021;3;Niederösterreich;5879319;1487543;4391776;163860
2021;4;Oberösterreich;3723290;634877;3088413;103770
2021;5;Salzburg;1552358;331327;1221031;43265
2021;6;Steiermark;3125254;612388;2512866;87103
2021;7;Tirol;2665899;759518;1906381;74300
2021;8;Vorarlberg;1482416;211060;1271356;41316
2021;9;Wien;5320157;2518947;2801210;148276
2021;10;Österreich;25868498;7003627;18864871;720970
2021;1;Burgenland;1056992;190718;866274;29459
2021;2;Kärnten;1073542;258421;815121;29920
2021;3;Niederösterreich;5950688;1500073;4450615;165849
2021;4;Oberösterreich;3777942;636911;3141031;105293
2021;5;Salzburg;1574675;333300;1241375;43887
2021;6;Steiermark;3155878;615068;2540810;87956
2021;7;Tirol;2680352;764801;1915551;74703
2021;8;Vorarlberg;1506813;211873;1294940;41996
2021;9;Wien;5384956;2568944;2816012;150082
2021;10;Österreich;26161838;7080109;19081729;729146
2021;1;Burgenland;1074010;192082;881928;29933
2021;2;Kärnten;1074447;259287;815160;29945
2021;3;Niederösterreich;6031253;1512942;4518311;168095
2021;4;Oberösterreich;3815087;639278;3175809;106329
2021;5;Salzburg;1599158;334662;1264496;44569
2021;6;Steiermark;3192321;617164;2575157;88972
2021;7;Tirol;2696118;769685;1926433;75142
2021;8;Vorarlberg;1541976;212752;1329224;42976
2021;9;Wien;5453864;2613347;2840517;152002
2021;10;Österreich;26478234;7151199;19327035;737964
2021;1;Burgenland;1080084;192865;887219;30103
2021;2;Kärnten;1075064;259873;815191;29963
2021;3;Niederösterreich;6091597;1522522;4569075;169776
2021;4;Oberösterreich;3838614;641239;3197375;106984
2021;5;Salzburg;1609352;335478;1273874;44854
2021;6;Steiermark;3218761;619362;2599399;89709
2021;7;Tirol;2710948;772907;1938041;75556
2021;8;Vorarlberg;1561244;213437;1347807;43513
2021;9;Wien;5493411;2636299;2857112;153105
2021;10;Österreich;26679075;7193982;19485093;743562
2021;1;Burgenland;1088980;193387;895593;30351
2021;2;Kärnten;1075839;260607;815232;29984
2021;3;Niederösterreich;6150105;1532200;4617905;171407
2021;4;Oberösterreich;3867780;642839;3224941;107797
2021;5;Salzburg;1610352;336166;1274186;44881
2021;6;Steiermark;3219891;620492;2599399;89740
2021;7;Tirol;2730185;777665;1952520;76092
2021;8;Vorarlberg;1570346;214084;1356262;43766
2021;9;Wien;5535105;2654569;2880536;154267
2021;10;Österreich;26848583;7232009;19616574;748286
2021;1;Burgenland;1103951;194033;909918;30768
2021;2;Kärnten;1078270;262976;815294;30052
2021;3;Niederösterreich;6231831;1540451;4691380;173685
2021;4;Oberösterreich;3919154;645042;3274112;109229
2021;5;Salzburg;1643547;337913;1305634;45807
2021;6;Steiermark;3268387;622791;2645596;91092
2021;7;Tirol;2745213;782826;1962387;76511
2021;8;Vorarlberg;1595090;214938;1380152;44456
2021;9;Wien;5612418;2699569;2912849;156421
2021;10;Österreich;27197861;7300539;19897322;758020
2021;1;Burgenland;1114375;195012;919363;31058
2021;2;Kärnten;1133191;264027;869164;31583
2021;3;Niederösterreich;6293966;1547429;4746537;175417
2021;4;Oberösterreich;3956051;647628;3308423;110257
2021;5;Salzburg;1661810;339601;1322209;46316
2021;6;Steiermark;3323246;628255;2694991;92621
2021;7;Tirol;2915780;788036;2127744;81265
2021;8;Vorarlberg;1615633;215594;1400039;45029
2021;9;Wien;5689086;2749355;2939731;158558
2021;10;Österreich;27703138;7374937;20328201;772103
2021;1;Burgenland;1124722;195989;928733;31347
2021;2;Kärnten;1134988;265061;869927;31633
2021;3;Niederösterreich;6372472;1559584;4812888;177605
2021;4;Oberösterreich;4017569;650147;3367422;111972
2021;5;Salzburg;1680364;341302;1339062;46833
2021;6;Steiermark;3350944;630804;2720140;93393
2021;7;Tirol;2930215;792534;2137681;81667
2021;8;Vorarlberg;1638246;216525;1421721;45659
2021;9;Wien;5762561;2794278;2968283;160606
2021;10;Österreich;28012081;7446224;20565857;780713
2021;1;Burgenland;1137008;197129;939879;31689
2021;2;Kärnten;1136054;266127;869927;31662
2021;3;Niederösterreich;6442862;1570743;4872119;179566
2021;4;Oberösterreich;4048640;652499;3396141;112838
2021;5;Salzburg;1698584;342628;1355956;47341
2021;6;Steiermark;3378556;632973;2745583;94162
2021;7;Tirol;2944140;796670;2147470;82055
2021;8;Vorarlberg;1661149;217215;1443934;46297
2021;9;Wien;5851627;2854118;2997509;163088
2021;10;Österreich;28298620;7530102;20768518;788699
2021;1;Burgenland;1154895;197915;956980;32188
2021;2;Kärnten;1137011;267048;869963;31689
2021;3;Niederösterreich;6520787;1582013;4938774;181738
2021;4;Oberösterreich;4084120;655064;3429056;113827
2021;5;Salzburg;1720004;343055;1376949;47938
2021;6;Steiermark;3416045;635057;2780988;95207
2021;7;Tirol;2959494;801051;2158443;82483
2021;8;Vorarlberg;1696208;218209;1477999;47274
2021;9;Wien;5927405;2899267;3028138;165200
2021;10;Österreich;28615969;7598679;21017290;797544
2021;1;Burgenland;1163700;198548;965152;32433
2021;2;Kärnten;1137889;267899;869990;31714
2021;3;Niederösterreich;6575467;1592651;4982816;183262
2021;4;Oberösterreich;4105264;657015;3448249;114416
2021;5;Salzburg;1730191;344745;1385446;48221
2021;6;Steiermark;3441078;636705;2804373;95905
2021;7;Tirol;2972051;804834;2167217;82833
2021;8;Vorarlberg;1714868;218906;1495962;47794
2021;9;Wien;5983389;2929580;3053809;166761
2021;10;Österreich;28823897;7650883;21173014;803339
2021;1;Burgenland;1171788;199123;972665;32658
2021;2;Kärnten;1138933;268927;870006;31743
2021;3;Niederösterreich;6650205;1601724;5048481;185345
2021;4;Oberösterreich;4134116;658828;3475288;115220
2021;5;Salzburg;1731233;345588;1385645;48250
2021;6;Steiermark;3442908;638535;2804373;95956
2021;7;Tirol;2988916;809010;2179906;83303
2021;8;Vorarlberg;1723374;219697;1503677;48031
2021;9;Wien;6033077;2946385;3086692;168145
2021;10;Österreich;29014550;7687817;21326733;808653
2021;1;Burgenland;1189714;199704;990010;33158
2021;2;Kärnten;1139991;269985;870006;31772
2021;3;Niederösterreich;6730991;1608879;5122112;187597
2021;4;Oberösterreich;4185277;661486;3523791;116646
2021;5;Salzburg;1761166;347324;1413842;49085
2021;6;Steiermark;3479116;642020;2837096;96965
2021;7;Tirol;3003253;813888;2189365;83702
2021;8;Vorarlberg;1749147;220584;1528563;48750
2021;9;Wien;6096511;2984751;3111760;169913
2021;10;Österreich;29335166;7748621;21586545;817588
2021;1;Burgenland;1202809;200292;1002517;33523
2021;2;Kärnten;1202792;272272;930520;33523
2021;3;Niederösterreich;6790389;1616859;5173530;189252
2021;4;Oberösterreich;4240167;664034;3576133;118176
2021;5;Salzburg;1518728;348700;1170028;42328
2021;6;Steiermark;3564343;646316;2918027;99340
2021;7;Tirol;3129479;818608;2310871;87220
2021;8;Vorarlberg;1773612;221386;1552226;49432
2021;9;Wien;6175290;3044452;3130838;172109
2021;10;Österreich;29597609;7832919;21764690;824903
2021;1;Burgenland;1214446;200475;1013971;33847
2021;2;Kärnten;1204349;273237;931112;33566
2021;3;Niederösterreich;6876060;1628799;5247261;191640
2021;4;Oberösterreich;4293292;666284;3627008;119657
2021;5;Salzburg;1532902;350537;1182365;42723
2021;6;Steiermark;3598517;648566;2949951;100293
2021;7;Tirol;3142482;822862;2319620;87583
2021;8;Vorarlberg;1798832;222269;1576563;50135
2021;9;Wien;6244690;3092399;3152291;174043
2021;10;Österreich;29905570;7905428;22000142;833486
2021;1;Burgenland;1231480;201562;1029918;34322
2021;2;Kärnten;1205413;274301;931112;33596
2021;3;Niederösterreich;6935793;1637977;5297816;193305
2021;4;Oberösterreich;4327249;669163;3658086;120603
2021;5;Salzburg;1546930;352320;1194610;43114
2021;6;Steiermark;3631516;651527;2979989;101212
2021;7;Tirol;3156998;827453;2329545;87987
2021;8;Vorarlberg;1825998;223510;1602488;50892
2021;9;Wien;6325084;3150598;3174486;176284
2021;10;Österreich;30186461;7988411;22198050;841314
2021;1;Burgenland;1248424;203871;1044553;34794
2021;2;Kärnten;1206460;275290;931170;33625
2021;3;Niederösterreich;7012894;1647745;5365149;195453
2021;4;Oberösterreich;4361230;671358;3689872;121550
2021;5;Salzburg;1564143;353228;1210915;43594
2021;6;Steiermark;3668920;653834;3015086;102255
2021;7;Tirol;3172521;832538;2339983;88420
2021;8;Vorarlberg;1862837;224465;1638372;51918
2021;9;Wien;6391625;3192843;3198782;178138
2021;10;Österreich;30489054;8055172;22433882;849748
2021;1;Burgenland;1254623;204591;1050032;34967
2021;2;Kärnten;1207518;276321;931197;33654
2021;3;Niederösterreich;7058283;1656270;5402013;196719
2021;4;Oberösterreich;4381457;673415;3708042;122114
2021;5;Salzburg;1572482;354166;1218316;43826
2021;6;Steiermark;3693524;655814;3037710;102941
2021;7;Tirol;3184728;835790;2348938;88760
2021;8;Vorarlberg;1883502;225483;1658019;52494
2021;9;Wien;6452495;3235451;3217044;179835
2021;10;Österreich;30688612;8117301;22571311;855310
2021;1;Burgenland;1263842;205175;1058667;35224
2021;2;Kärnten;1208264;277020;931244;33675
2021;3;Niederösterreich;7094047;1663300;5430747;197715
2021;4;Oberösterreich;4409268;675453;3733815;122889
2021;5;Salzburg;1573674;355187;1218487;43859
2021;6;Steiermark;3695653;657943;3037710;103000
2021;7;Tirol;3201879;839405;2362474;89238
2021;8;Vorarlberg;1895824;226219;1669605;52838
2021;9;Wien;6493900;3251340;3242560;180989
2021;10;Österreich;30836351;8151042;22685309;859427
2021;1;Burgenland;1276822;205738;1071084;35586
2021;2;Kärnten;1208866;277596;931270;33692
2021;3;Niederösterreich;7154029;1668081;5485948;199387
2021;4;Oberösterreich;4459169;677635;3781534;124280
2021;5;Salzburg;1600367;356773;1243594;44603
2021;6;Steiermark;3750005;660673;3089332;104515
2021;7;Tirol;3328477;843909;2484568;92767
2021;8;Vorarlberg;1924083;227129;1696954;53625
2021;9;Wien;6561234;3298593;3262641;182865
2021;10;Österreich;31263052;8216127;23046925;871320
2021;1;Burgenland;1291681;206442;1085239;36000
2021;2;Kärnten;1161128;280360;880768;32361
2021;3;Niederösterreich;7208320;1674195;5534125;200900
2021;4;Oberösterreich;4389973;680107;3709866;122351
2021;5;Salzburg;1613703;358134;1255569;44975
2021;6;Steiermark;3708703;663225;3045478;103364
2021;7;Tirol;3340308;848486;2491822;93096
2021;8;Vorarlberg;1950206;228431;1721775;54353
2021;9;Wien;6653687;3367080;3286607;185442
2021;10;Österreich;31317709;8306460;23011249;872843
2021;1;Burgenland;1300878;207208;1093670;36256
2021;2;Kärnten;1164016;281243;882773;32442
2021;3;Niederösterreich;7268736;1684338;5584398;202584
2021;4;Oberösterreich;4444219;682620;3761599;123863
2021;5;Salzburg;1628525;359739;1268786;45388
2021;6;Steiermark;3742240;668175;3074065;104298
2021;7;Tirol;3361451;852764;2508687;93686
2021;8;Vorarlberg;1976810;229525;1747285;55095
2021;9;Wien;6702849;3395756;3307093;186812
2021;10;Österreich;31589724;8361368;23228356;880424
2021;1;Burgenland;1316161;208076;1108085;36682
2021;2;Kärnten;1166943;282148;884795;32523
2021;3;Niederösterreich;7308464;1692649;5615815;203691
2021;4;Oberösterreich;4477521;685211;3792310;124791
2021;5;Salzburg;1645400;361401;1283999;45858
2021;6;Steiermark;3778686;671026;3107660;105314
2021;7;Tirol;3374877;856819;2518058;94060
2021;8;Vorarlberg;2004875;230807;1774068;55877
2021;9;Wien;6819977;3482080;3337897;190077
2021;10;Österreich;31892904;8470217;23422687;888874
2021;1;Burgenland;1339910;208614;1131296;37344
2021;2;Kärnten;1197118;283041;914077;33364
2021;3;Niederösterreich;7373844;1701278;5672566;205513
2021;4;Oberösterreich;4510075;687359;3822716;125698
2021;5;Salzburg;1665986;362533;1303453;46432
2021;6;Steiermark;3817717;673360;3144357;106402
2021;7;Tirol;3388931;860969;2527962;94452
2021;8;Vorarlberg;2043302;232607;1810695;56948
2021;9;Wien;6891523;3527538;3363985;192071
2021;10;Österreich;32228406;8537299;23691107;898225
2021;1;Burgenland;1345076;209031;1136045;37488
2021;2;Kärnten;1197990;283806;914184;33389
2021;3;Niederösterreich;7405558;1708412;5697146;206397
2021;4;Oberösterreich;4525493;689413;3836080;126128
2021;5;Salzburg;1676569;363224;1313345;46727
2021;6;Steiermark;3831785;675232;3156553;106794
2021;7;Tirol;3400214;863723;2536491;94766
2021;8;Vorarlberg;2063720;233550;1830170;57517
2021;9;Wien;6937569;3551529;3386040;193354
2021;10;Österreich;32383974;8577920;23806054;902560
2021;1;Burgenland;1352004;209835;1142169;37681
2021;2;Kärnten;1198413;284114;914299;33400
2021;3;Niederösterreich;7446666;1715671;5730995;207543
2021;4;Oberösterreich;4553813;690937;3862876;126917
2021;5;Salzburg;1678692;364030;1314662;46786
2021;6;Steiermark;3834070;677105;3156965;106858
2021;7;Tirol;3418004;867595;2550409;95262
2021;8;Vorarlberg;2076646;234456;1842190;57877
2021;9;Wien;6937569;3551529;3386040;193354
2021;10;Österreich;32495877;8595272;23900605;905679
2021;1;Burgenland;1369564;210319;1159245;38171
2021;2;Kärnten;1199456;285157;914299;33430
2021;3;Niederösterreich;7496161;1721394;5774767;208922
2021;4;Oberösterreich;4617613;693135;3924478;128696
2021;5;Salzburg;1710527;365731;1344796;47673
2021;6;Steiermark;3890389;680785;3209604;108427
2021;7;Tirol;3430976;871421;2559555;95623
2021;8;Vorarlberg;2105596;235303;1870293;58684
2021;9;Wien;7075011;3617555;3457456;197185
2021;10;Österreich;32895293;8680800;24214493;916811
2021;1;Burgenland;1381715;211163;1170552;38509
2021;2;Kärnten;1223220;287231;935989;34092
2021;3;Niederösterreich;7562753;1726672;5836081;210778
2021;4;Oberösterreich;4652977;696128;3956849;129681
2021;5;Salzburg;1725579;367058;1358521;48093
2021;6;Steiermark;3943277;684791;3258486;109901
2021;7;Tirol;3444450;875919;2568531;95999
2021;8;Vorarlberg;2131720;236622;1895098;59412
2021;9;Wien;7175992;3691904;3484088;199999
2021;10;Österreich;33241683;8777488;24464195;926465
2021;1;Burgenland;1393362;211995;1181367;38834
2021;2;Kärnten;1225046;288166;936880;34143
2021;3;Niederösterreich;7634765;1735894;5898871;212785
2021;4;Oberösterreich;4706863;698033;4008830;131183
2021;5;Salzburg;1743147;368401;1374746;48583
2021;6;Steiermark;3978238;688286;3289952;110876
2021;7;Tirol;3585669;878024;2707645;99935
2021;8;Vorarlberg;2158163;237500;1920663;60149
2021;9;Wien;7277006;3756756;3520250;202814
2021;10;Österreich;33702259;8863055;24839204;939302
2021;1;Burgenland;1406623;212773;1193850;39203
2021;2;Kärnten;1225824;288872;936952;34164
2021;3;Niederösterreich;7695901;1743527;5952374;214489
2021;4;Oberösterreich;4739112;700262;4038850;132082
2021;5;Salzburg;1757951;369739;1388212;48995
2021;6;Steiermark;4011351;690933;3320418;111799
2021;7;Tirol;3601073;884909;2716164;100364
2021;8;Vorarlberg;2185984;238900;1947084;60925
2021;9;Wien;7366369;3818725;3547644;205305
2021;10;Österreich;33990188;8948640;25041548;947327
2021;1;Burgenland;1424333;213072;1211261;39697
2021;2;Kärnten;1226748;289743;937005;34190
2021;3;Niederösterreich;7760621;1751360;6009261;216293
2021;4;Oberösterreich;4773735;702278;4071457;133047
2021;5;Salzburg;1779423;370692;1408731;49594
2021;6;Steiermark;4051628;693489;3358139;112921
2021;7;Tirol;3613854;888965;2724889;100720
2021;8;Vorarlberg;2226116;240459;1985657;62043
2021;9;Wien;7443504;3868699;3574805;207455
2021;10;Österreich;34299962;9018757;25281205;955960
2021;1;Burgenland;1431182;214232;1216950;39888
2021;2;Kärnten;1227262;290228;937034;34205
2021;3;Niederösterreich;7804041;1758513;6045528;217503
2021;4;Oberösterreich;4794344;703829;4090515;133621
2021;5;Salzburg;1790871;371351;1419520;49913
2021;6;Steiermark;4076337;694960;3381377;113610
2021;7;Tirol;3623459;891351;2732108;100988
2021;8;Vorarlberg;2250566;241525;2009041;62725
2021;9;Wien;7506115;3912404;3593711;209200
2021;10;Österreich;34504177;9078393;25425784;961652
2021;1;Burgenland;1439691;214731;1224960;40125
2021;2;Kärnten;1227666;290578;937088;34216
2021;3;Niederösterreich;7837987;1764758;6073229;218449
2021;4;Oberösterreich;4818439;704919;4113520;134293
2021;5;Salzburg;1794193;372088;1422105;50005
2021;6;Steiermark;4078199;696822;3381377;113662
2021;7;Tirol;3636270;893835;2742435;101345
2021;8;Vorarlberg;2263315;242150;2021165;63080
2021;9;Wien;7543873;3925691;3618182;210252
2021;10;Österreich;34639633;9105572;25534061;965427
2021;1;Burgenland;1455545;215140;1240405;40567
2021;2;Kärnten;1229754;291622;938132;34274
2021;3;Niederösterreich;7907389;1769112;6138277;220384
2021;4;Oberösterreich;4876182;706790;4169392;135902
2021;5;Salzburg;1828764;372995;1455769;50969
2021;6;Steiermark;4129903;699906;3429997;115103
2021;7;Tirol;3646781;896419;2750362;101638
2021;8;Vorarlberg;2291760;243092;2048668;63873
2021;9;Wien;7637152;3984456;3652696;212852
2021;10;Österreich;35003230;9179532;25823698;975561
2021;1;Burgenland;1467008;215959;1251049;40886
2021;2;Kärnten;1309335;293731;1015604;36492
2021;3;Niederösterreich;7966852;1774254;6192598;222041
2021;4;Oberösterreich;4909829;708501;4201328;136840
2021;5;Salzburg;1844034;374117;1469917;51394
2021;6;Steiermark;4179323;703401;3475922;116480
2021;7;Tirol;3657922;900261;2757661;101948
2021;8;Vorarlberg;2313789;244115;2069674;64487
2021;9;Wien;7734926;4054658;3680268;215577
2021;10;Österreich;35383018;9268997;26114021;986146
2021;1;Burgenland;1478247;216436;1261811;41200
2021;2;Kärnten;1311192;294320;1016872;36544
2021;3;Niederösterreich;8024719;1781644;6243075;223654
2021;4;Oberösterreich;4959174;710043;4249131;138215
2021;5;Salzburg;1862735;375873;1486862;51916
2021;6;Steiermark;4219812;706135;3513677;117609
2021;7;Tirol;3779126;903563;2875563;105326
2021;8;Vorarlberg;2341732;245298;2096434;65265
2021;9;Wien;7821975;4115874;3706101;218003
2021;10;Österreich;35798712;9349186;26449526;997731
2021;1;Burgenland;1486326;217283;1269043;41425
2021;2;Kärnten;1311813;294911;1016902;36561
2021;3;Niederösterreich;8055822;1787701;6268121;224521
2021;4;Oberösterreich;4978489;711404;4267085;138753
2021;5;Salzburg;1870174;376735;1493439;52123
2021;6;Steiermark;4221618;707667;3513951;117659
2021;7;Tirol;3790391;905979;2884412;105640
2021;8;Vorarlberg;2358960;246106;2112854;65746
2021;9;Wien;7866320;4136206;3730114;219239
2021;10;Österreich;35939913;9383992;26555921;1001667
2021;1;Burgenland;1504261;217701;1286560;41925
2021;2;Kärnten;1312408;295474;1016934;36578
2021;3;Niederösterreich;8113423;1794442;6318981;226126
2021;4;Oberösterreich;5009678;712844;4296834;139623
2021;5;Salzburg;1889696;377202;1512494;52667
2021;6;Steiermark;4262577;709788;3552789;118801
2021;7;Tirol;3801169;908432;2892737;105941
2021;8;Vorarlberg;2391484;246827;2144657;66652
2021;9;Wien;7932899;4175585;3757314;221095
2021;10;Österreich;36217595;9438295;26779300;1009406
2021;1;Burgenland;1509785;218160;1291625;42079
2021;2;Kärnten;1312915;295960;1016955;36592
2021;3;Niederösterreich;8147830;1798439;6349391;227085
2021;4;Oberösterreich;5026717;714031;4312686;140098
2021;5;Salzburg;1898269;377747;1520522;52906
2021;6;Steiermark;4285484;711316;3574168;119439
2021;7;Tirol;3809353;910463;2898890;106169
2021;8;Vorarlberg;2410258;247869;2162389;67175
2021;9;Wien;7992464;4215933;3776531;222755
2021;10;Österreich;36393075;9489918;26903157;1014296
2021;1;Burgenland;1517991;218629;1299362;42307
2021;2;Kärnten;1313439;296449;1016990;36606
2021;3;Niederösterreich;8178563;1802952;6375611;227941
2021;4;Oberösterreich;5051147;715205;4335942;140778
2021;5;Salzburg;1898993;378296;1520697;52926
2021;6;Steiermark;4287187;713019;3574168;119486
2021;7;Tirol;3822593;912487;2910106;106538
2021;8;Vorarlberg;2417817;248380;2169437;67386
2021;9;Wien;8043717;4238580;3805137;224183
2021;10;Österreich;36531447;9523997;27007450;1018153
2021;1;Burgenland;1533956;219156;1314800;42752
2021;2;Kärnten;1314141;297084;1017057;36626
2021;3;Niederösterreich;8235423;1807103;6428320;229526
2021;4;Oberösterreich;5094728;716639;4378089;141993
2021;5;Salzburg;1927721;379229;1548492;53727
2021;6;Steiermark;4336839;714486;3622353;120870
2021;7;Tirol;3832350;915335;2917015;106810
2021;8;Vorarlberg;2440424;249161;2191263;68016
2021;9;Wien;8125236;4297285;3827951;226455
2021;10;Österreich;36840818;9595478;27245340;1026775
2021;1;Burgenland;1548756;219627;1329129;43165
2021;2;Kärnten;1350222;297511;1052711;37631
2021;3;Niederösterreich;8316175;1814099;6502076;231777
2021;4;Oberösterreich;5136216;718680;4417536;143149
2021;5;Salzburg;1943649;380503;1563146;54171
2021;6;Steiermark;4399664;717418;3682246;122621
2021;7;Tirol;3845363;918350;2927013;107173
2021;8;Vorarlberg;2458279;250017;2208262;68514
2021;9;Wien;8239058;4385268;3853790;229627
2021;10;Österreich;37237382;9701473;27535909;1037828
2021;1;Burgenland;1563307;220246;1343061;43570
2021;2;Kärnten;1352816;299252;1053564;37704
2021;3;Niederösterreich;8400686;1823319;6577367;234132
2021;4;Oberösterreich;5202123;719694;4482429;144986
2021;5;Salzburg;1968147;381421;1586726;54853
2021;6;Steiermark;4456349;719508;3736841;124201
2021;7;Tirol;3862170;922863;2939307;107641
2021;8;Vorarlberg;2480216;250658;2229558;69125
2021;9;Wien;8340220;4447794;3892426;232447
2021;10;Österreich;37626034;9784755;27841279;1048660
2021;1;Burgenland;1574418;220906;1353512;43880
2021;2;Kärnten;1359493;299577;1059916;37890
2021;3;Niederösterreich;8442978;1831241;6611737;235311
2021;4;Oberösterreich;5242055;721057;4520998;146099
2021;5;Salzburg;1987040;383055;1603985;55380
2021;6;Steiermark;4498321;721208;3777113;125371
2021;7;Tirol;3975707;925845;3049862;110805
2021;8;Vorarlberg;2498381;251478;2246903;69631
2021;9;Wien;8471793;4542807;3928986;236114
2021;10;Österreich;38050186;9897174;28153012;1060481
2021;1;Burgenland;1602084;221489;1380595;44651
2021;2;Kärnten;1360969;300069;1060900;37931
2021;3;Niederösterreich;8558956;1837419;6721537;238543
2021;4;Oberösterreich;5296575;722160;4574415;147619
2021;5;Salzburg;2019534;383519;1636015;56286
2021;6;Steiermark;4570020;722943;3847077;127369
2021;7;Tirol;3993726;928984;3064742;111307
2021;8;Vorarlberg;2529280;252204;2277076;70493
2021;9;Wien;8598393;4623577;3974816;239642
2021;10;Österreich;38529537;9992364;28537173;1073841
2021;1;Burgenland;1614604;221583;1393021;45000
2021;2;Kärnten;1361273;300350;1060923;37939
2021;3;Niederösterreich;8631708;1842380;6789328;240571
2021;4;Oberösterreich;5337719;723022;4614697;148765
2021;5;Salzburg;2042689;383947;1658742;56931
2021;6;Steiermark;4623087;723899;3899188;128848
2021;7;Tirol;4011721;931207;3080514;111809
2021;8;Vorarlberg;2548467;252951;2295516;71027
2021;9;Wien;8706441;4687627;4018814;242654
2021;10;Österreich;38877709;10066966;28810743;1083545
2021;1;Burgenland;1626356;222039;1404317;45328
2021;2;Kärnten;1361533;300599;1060934;37947
2021;3;Niederösterreich;8674411;1846540;6827871;241761
2021;4;Oberösterreich;5369323;724205;4645118;149646
2021;5;Salzburg;2044067;384270;1659797;56969
2021;6;Steiermark;4642645;724823;3917822;129393
2021;7;Tirol;4030998;933202;3097796;112346
2021;8;Vorarlberg;2556281;253591;2302690;71245
2021;9;Wien;8783610;4722279;4061331;244804
2021;10;Österreich;39089224;10111548;28977676;1089440
2021;1;Burgenland;1637958;222430;1415528;45651
2021;2;Kärnten;1364105;303164;1060941;38018
2021;3;Niederösterreich;8727483;1851169;6876314;243240
2021;4;Oberösterreich;5456970;725145;4731825;152089
2021;5;Salzburg;2060793;384711;1676082;57436
2021;6;Steiermark;4744944;725676;4019268;132244
2021;7;Tirol;4050839;935504;3115335;112899
2021;8;Vorarlberg;2568768;254068;2314700;71593
2021;9;Wien;8859658;4748477;4111181;246924
2021;10;Österreich;39471518;10150344;29321174;1100094
2021;1;Burgenland;1653636;222973;1430663;46088
2021;2;Kärnten;1397311;303562;1093749;38944
2021;3;Niederösterreich;8809015;1855373;6953642;245512
2021;4;Oberösterreich;5482943;726616;4756327;152813
2021;5;Salzburg;2105841;386013;1719828;58691
2021;6;Steiermark;4832028;727554;4104474;134671
2021;7;Tirol;4065841;938024;3127817;113317
2021;8;Vorarlberg;2588098;254567;2333531;72132
2021;9;Wien;8979797;4824857;4154940;250272
2021;10;Österreich;39914510;10239539;29674971;1112441
2021;1;Burgenland;1665407;223639;1441768;46416
2021;2;Kärnten;1465110;304252;1160858;40833
2021;3;Niederösterreich;8870648;1859266;7011382;247230
2021;4;Oberösterreich;5563074;727860;4835214;155046
2021;5;Salzburg;2122292;387267;1735025;59150
2021;6;Steiermark;4904697;729467;4175230;136697
2021;7;Tirol;4142109;940911;3201198;115443
2021;8;Vorarlberg;2603856;255249;2348607;72571
2021;9;Wien;9119645;4929756;4189889;254170
2021;10;Österreich;40456838;10357667;30099171;1127556
2021;1;Burgenland;1681489;224100;1457389;46864
2021;2;Kärnten;1465132;304252;1160880;40834
2021;3;Niederösterreich;8927523;1865232;7062291;248815
2021;4;Oberösterreich;5592840;729026;4863814;155876
2021;5;Salzburg;2137210;388655;1748555;59565
2021;6;Steiermark;4973341;730874;4242467;138610
2021;7;Tirol;4155773;943641;3212132;115824
2021;8;Vorarlberg;2619597;256014;2363583;73010
2021;9;Wien;9236221;5012425;4223796;257419
2021;10;Österreich;40789126;10454219;30334907;1136817
2021;1;Burgenland;1704353;225069;1479284;47501
2021;2;Kärnten;1466702;305042;1161660;40878
2021;3;Niederösterreich;9006552;1871063;7135489;251018
2021;4;Oberösterreich;5638147;730166;4907981;157138
2021;5;Salzburg;2181257;389366;1791891;60793
2021;6;Steiermark;5063656;732162;4331494;141127
2021;7;Tirol;4173329;946385;3226944;116313
2021;8;Vorarlberg;2645775;256764;2389011;73739
2021;9;Wien;9344468;5076086;4268382;260436
2021;10;Österreich;41224239;10532103;30692136;1148944
2021;1;Burgenland;1718043;225702;1492341;47883
2021;2;Kärnten;1466953;305275;1161678;40885
2021;3;Niederösterreich;9066796;1876057;7190739;252697
2021;4;Oberösterreich;5638796;730704;4908092;157157
2021;5;Salzburg;2222303;389770;1832533;61937
2021;6;Steiermark;5132802;732974;4399828;143054
2021;7;Tirol;4188903;948115;3240788;116747
2021;8;Vorarlberg;2660255;257316;2402939;74143
2021;9;Wien;9468873;5157057;4311816;263903
2021;10;Österreich;41563724;10622970;30940754;1158406
2021;1;Burgenland;1727866;226111;1501755;48157
2021;2;Kärnten;1467424;305746;1161678;40898
2021;3;Niederösterreich;9104097;1880120;7223977;253737
2021;4;Oberösterreich;5639735;731444;4908291;157183
2021;5;Salzburg;2248912;390140;1858772;62679
2021;6;Steiermark;5179808;734855;4444953;144364
2021;7;Tirol;4206311;950244;3256067;117232
2021;8;Vorarlberg;2666184;257885;2408299;74308
2021;9;Wien;9535872;5183239;4352633;265770
2021;10;Österreich;41776209;10659784;31116425;1164328
2021;1;Burgenland;1743240;226620;1516620;48585
2021;2;Kärnten;1467836;306158;1161678;40909
2021;3;Niederösterreich;9165500;1883723;7281777;255448
2021;4;Oberösterreich;5648327;732550;4915777;157422
2021;5;Salzburg;2292718;391139;1901579;63899
2021;6;Steiermark;5254136;735548;4518588;146436
2021;7;Tirol;4220340;952800;3267540;117623
2021;8;Vorarlberg;2681953;258478;2423475;74748
2021;9;Wien;9648499;5257940;4390559;268909
2021;10;Österreich;42122549;10744956;31377593;1173980
2021;1;Burgenland;1755748;227278;1528470;48934
2021;2;Kärnten;1513700;306597;1207103;42188
2021;3;Niederösterreich;9215471;1887489;7327982;256841
2021;4;Oberösterreich;6186623;733769;5452854;172425
2021;5;Salzburg;2327933;392256;1935677;64881
2021;6;Steiermark;5334198;737960;4596238;148667
2021;7;Tirol;4234223;955227;3278996;118010
2021;8;Vorarlberg;2693527;259127;2434400;75070
2021;9;Wien;9786653;5355498;4431155;272760
2021;10;Österreich;43048076;10855201;32192875;1199775
2021;1;Burgenland;1771077;227923;1543154;49361
2021;2;Kärnten;1515354;306993;1208361;42234
2021;3;Niederösterreich;9296476;1893055;7403421;259098
2021;4;Oberösterreich;6347909;734739;5613170;176920
2021;5;Salzburg;2375279;393250;1982029;66200
2021;6;Steiermark;5407581;738952;4668629;150712
2021;7;Tirol;4381873;957531;3424342;122125
2021;8;Vorarlberg;2713592;259566;2454026;75629
2021;9;Wien;9919962;5442983;4476979;276475
2021;10;Österreich;43729103;10954992;32774111;1218756
2021;1;Burgenland;1796354;228307;1568047;50065
2021;2;Kärnten;1515535;307174;1208361;42239
2021;3;Niederösterreich;9343787;1897339;7446448;260417
2021;4;Oberösterreich;6416222;735603;5680619;178824
2021;5;Salzburg;2415076;393597;2021479;67310
2021;6;Steiermark;5480189;745053;4735136;152736
2021;7;Tirol;4401121;959640;3441481;122662
2021;8;Vorarlberg;2723752;259862;2463890;75913
2021;9;Wien;10018309;5486686;4531623;279216
2021;10;Österreich;44110345;11013261;33097084;1229381
2021;1;Burgenland;1820591;228711;1591880;50741
2021;2;Kärnten;1621778;307174;1314604;45200
2021;3;Niederösterreich;9420683;1902479;7518204;262560
2021;4;Oberösterreich;6600593;736420;5864173;183962
2021;5;Salzburg;2473506;394563;2078943;68938
2021;6;Steiermark;5608953;746862;4862091;156325
2021;7;Tirol;4418730;961625;3457105;123153
2021;8;Vorarlberg;2744656;260277;2484379;76495
2021;9;Wien;10149504;5554214;4595290;282873
2021;10;Österreich;44858994;11092325;33766669;1250247
2021;1;Burgenland;1837099;229210;1607889;51201
2021;2;Kärnten;1622297;307693;1314604;45214
2021;3;Niederösterreich;9471896;1906133;7565763;263987
2021;4;Oberösterreich;6700206;736844;5963362;186739
2021;5;Salzburg;2520970;394913;2126057;70261
2021;6;Steiermark;5692157;747278;4944879;158644
2021;7;Tirol;4436149;963283;3472866;123638
2021;8;Vorarlberg;2756379;260685;2495694;76822
2021;9;Wien;10241226;5611853;4629373;285429
2021;10;Österreich;45278379;11157892;34120487;1261935
2021;1;Burgenland;1850359;229563;1620796;51571
2021;2;Kärnten;1622432;307828;1314604;45218
2021;3;Niederösterreich;9505891;1909945;7595946;264935
2021;4;Oberösterreich;6779215;737601;6041614;188941
2021;5;Salzburg;2548188;395212;2152976;71020
2021;6;Steiermark;5743459;747747;4995712;160074
2021;7;Tirol;4453610;965177;3488433;124125
2021;8;Vorarlberg;2761583;261146;2500437;76967
2021;9;Wien;10306257;5630454;4675803;287241
2021;10;Österreich;45570994;11184673;34386321;1270090
2021;1;Burgenland;1865108;230133;1634975;51982
2021;2;Kärnten;1622983;308379;1314604;45233
2021;3;Niederösterreich;9554145;1913010;7641135;266280
2021;4;Oberösterreich;6851691;738569;6113122;190961
2021;5;Salzburg;2592217;396310;2195907;72247
2021;6;Steiermark;5814485;750363;5064122;162053
2021;7;Tirol;4464243;967196;3497047;124421
2021;8;Vorarlberg;2773203;261465;2511738;77291
2021;9;Wien;10444930;5709870;4735060;291106
2021;10;Österreich;45983005;11275295;34707710;1281573
2021;1;Burgenland;1874198;230737;1643461;52235
2021;2;Kärnten;1623397;308793;1314604;45245
2021;3;Niederösterreich;9585653;1916292;7669361;267158
2021;4;Oberösterreich;6916778;739450;6177328;192775
2021;5;Salzburg;2617680;397477;2220203;72956
2021;6;Steiermark;5888257;752543;5135714;164109
2021;7;Tirol;4582056;968958;3613098;127705
2021;8;Vorarlberg;2781377;261933;2519444;77519
2021;9;Wien;10556770;5789102;4767668;294223
2021;10;Österreich;46426166;11365285;35060881;1293925
2021;1;Burgenland;1893858;230936;1662922;52783
2021;2;Kärnten;1804702;311115;1493587;50298
2021;3;Niederösterreich;9623375;1921197;7702178;268209
2021;4;Oberösterreich;6985491;740212;6245279;194690
2021;5;Salzburg;2645894;398287;2247607;73743
2021;6;Steiermark;5946210;753305;5192905;165724
2021;7;Tirol;4590996;970419;3620577;127954
2021;8;Vorarlberg;2792740;262234;2530506;77835
2021;9;Wien;10659403;5858801;4800602;297084
2021;10;Österreich;46942669;11446506;35496163;1308320
2021;1;Burgenland;1905410;231410;1674000;53105
2021;2;Kärnten;1804890;311303;1493587;50303
2021;3;Niederösterreich;9665399;1926378;7739021;269380
2021;4;Oberösterreich;7048854;740942;6307912;196456
2021;5;Salzburg;2672794;399355;2273439;74492
2021;6;Steiermark;6000972;754970;5246002;167251
2021;7;Tirol;4599197;971552;3627645;128182
2021;8;Vorarlberg;2801409;262520;2538889;78077
2021;9;Wien;10769255;5933991;4835264;300145
2021;10;Österreich;47268180;11532421;35735759;1317392
2021;1;Burgenland;1930444;231680;1698764;53803
2021;2;Kärnten;1805034;311447;1493587;50307
2021;3;Niederösterreich;9715155;1930385;7784770;270767
2021;4;Oberösterreich;7145413;741611;6403802;199147
2021;5;Salzburg;2712073;399772;2312301;75587
2021;6;Steiermark;6091501;755827;5335674;169774
2021;7;Tirol;4611397;973256;3638141;128522
2021;8;Vorarlberg;2818988;262720;2556268;78567
2021;9;Wien;10895429;5961239;4934190;303662
2021;10;Österreich;47725434;11567937;36157497;1330136
2021;1;Burgenland;1944166;231737;1712429;54185
2021;2;Kärnten;1805141;311554;1493587;50310
2021;3;Niederösterreich;9797671;1933817;7863854;273067
2021;4;Oberösterreich;7240165;742072;6498093;201788
2021;5;Salzburg;2751407;400060;2351347;76683
2021;6;Steiermark;6171433;756336;5415097;172001
2021;7;Tirol;4620870;973869;3647001;128786
2021;8;Vorarlberg;2828315;262903;2565412;78827
2021;9;Wien;10986811;6010976;4975835;306209
2021;10;Österreich;48145979;11623324;36522655;1341857
2021;1;Burgenland;1959166;231941;1727225;54603
2021;2;Kärnten;1805558;311971;1493587;50322
2021;3;Niederösterreich;9832538;1937064;7895474;274039
2021;4;Oberösterreich;7331751;742649;6589102;204340
2021;5;Salzburg;2782675;400246;2382429;77555
2021;6;Steiermark;6235105;757541;5477564;173776
2021;7;Tirol;4631104;974562;3656542;129072
2021;8;Vorarlberg;2832446;263227;2569219;78942
2021;9;Wien;11048387;6030153;5018234;307925
2021;10;Österreich;48458730;11649354;36809376;1350573
2021;1;Burgenland;1972399;232155;1740244;54972
2021;2;Kärnten;1805701;312114;1493587;50326
2021;3;Niederösterreich;9872454;1939447;7933007;275151
2021;4;Oberösterreich;7391731;743284;6648447;206012
2021;5;Salzburg;2829182;401152;2428030;78851
2021;6;Steiermark;6302992;758805;5544187;175668
2021;7;Tirol;4639446;975972;3663474;129304
2021;8;Vorarlberg;2842061;263438;2578623;79210
2021;9;Wien;11157197;6104014;5053183;310958
2021;10;Österreich;48813163;11730381;37082782;1360452
2021;1;Burgenland;1983066;232349;1750717;55269
2021;2;Kärnten;1806568;312746;1493822;50350
2021;3;Niederösterreich;9956708;1942883;8013825;277499
2021;4;Oberösterreich;7457570;744110;6713460;207847
2021;5;Salzburg;2855325;402200;2453125;79580
2021;6;Steiermark;6356020;759726;5596294;177146
2021;7;Tirol;4645623;977135;3668488;129476
2021;8;Vorarlberg;2849408;263729;2585679;79415
2021;9;Wien;11257571;6173260;5084311;313755
2021;10;Österreich;49167859;11808138;37359721;1370337
2021;1;Burgenland;1995247;232400;1762847;55609
2021;2;Kärnten;1975056;314844;1660212;55046
2021;3;Niederösterreich;10028225;1947553;8080672;279493
2021;4;Oberösterreich;7528779;744746;6784033;209832
2021;5;Salzburg;2884812;403031;2481781;80401
2021;6;Steiermark;6407654;760738;5646916;178585
2021;7;Tirol;4653426;978643;3674783;129694
2021;8;Vorarlberg;2858657;263916;2594741;79672
2021;9;Wien;11362050;6246701;5115349;316667
2021;10;Österreich;49693906;11892572;37801334;1384998
2021;1;Burgenland;2006024;232751;1773273;55909
2021;2;Kärnten;1977261;315169;1662092;55107
2021;3;Niederösterreich;10116833;1951470;8165363;281962
2021;4;Oberösterreich;7595397;745500;6849897;211688
2021;5;Salzburg;2913134;404058;2509076;81191
2021;6;Steiermark;6469877;761185;5708692;180319
2021;7;Tirol;4772236;979629;3792607;133005
2021;8;Vorarlberg;2865649;264068;2601581;79867
2021;9;Wien;11467186;6316206;5150980;319597
2021;10;Österreich;50183597;11970036;38213561;1398646
2021;1;Burgenland;2026391;232923;1793468;56477
2021;2;Kärnten;1977462;315370;1662092;55113
2021;3;Niederösterreich;10222213;1955315;8266898;284899
2021;4;Oberösterreich;7687434;746058;6941376;214253
2021;5;Salzburg;2950878;404397;2546481;82243
2021;6;Steiermark;6555795;764261;5791534;182714
2021;7;Tirol;4783428;981678;3801750;133317
2021;8;Vorarlberg;2879780;264316;2615464;80261
2021;9;Wien;11580548;6387685;5192863;322757
2021;10;Österreich;50663929;12052003;38611926;1412034
2021;1;Burgenland;2039220;232946;1806274;56834
2021;2;Kärnten;1977544;315452;1662092;55115
2021;3;Niederösterreich;10320165;1958547;8361618;287629
2021;4;Oberösterreich;7776776;746432;7030344;216743
2021;5;Salzburg;2988333;404516;2583817;83287
2021;6;Steiermark;6634725;764562;5870163;184914
2021;7;Tirol;4792662;983031;3809631;133574
2021;8;Vorarlberg;2886022;264584;2621438;80435
2021;9;Wien;11667419;6431378;5236041;325178
2021;10;Österreich;51082866;12101448;38981418;1423710
2021;1;Burgenland;2052395;233118;1819277;57201
2021;2;Kärnten;1977658;315566;1662092;55118
2021;3;Niederösterreich;10414049;1961692;8452357;290246
2021;4;Oberösterreich;7863422;746865;7116557;219158
2021;5;Salzburg;3019003;404691;2614312;84141
2021;6;Steiermark;6702817;765124;5937693;186811
2021;7;Tirol;4801848;984069;3817779;133830
2021;8;Vorarlberg;2889717;264672;2625045;80538
2021;9;Wien;11736974;6457420;5279554;327116
2021;10;Österreich;51457883;12133217;39324666;1434162
2021;1;Burgenland;2063940;233253;1830687;57523
2021;2;Kärnten;1978219;316127;1662092;55134
2021;3;Niederösterreich;10484220;1964792;8519428;292201
2021;4;Oberösterreich;7920724;747531;7173193;220755
2021;5;Salzburg;3052367;405570;2646797;85071
2021;6;Steiermark;6766613;766533;6000080;188589
2021;7;Tirol;4809465;985873;3823592;134043
2021;8;Vorarlberg;3288639;264811;3023828;91656
2021;9;Wien;11799322;6486935;5312387;328854
2021;10;Österreich;52163509;12171425;39992084;1453828
2021;1;Burgenland;2073449;233388;1840061;57788
2021;2;Kärnten;1981055;318159;1662896;55213
2021;3;Niederösterreich;10553682;1967399;8586283;294137
2021;4;Oberösterreich;7973461;748197;7225264;222225
2021;5;Salzburg;3074226;406536;2667690;85680
2021;6;Steiermark;6853661;767167;6086494;191016
2021;7;Tirol;4815067;986689;3828378;134199
2021;8;Vorarlberg;3302104;264984;3037120;92032
2021;9;Wien;11926667;6586585;5340082;332403
2021;10;Österreich;52553372;12279104;40274268;1464693
2021;1;Burgenland;2083776;233527;1850249;58076
2021;2;Kärnten;1981250;318354;1662896;55219
2021;3;Niederösterreich;10621263;1971371;8649892;296021
2021;4;Oberösterreich;7994979;748796;7246183;222825
2021;5;Salzburg;3097940;407443;2690497;86341
2021;6;Steiermark;6909925;767963;6141962;192584
2021;7;Tirol;4821648;987556;3834092;134382
2021;8;Vorarlberg;3317855;265055;3052800;92471
2021;9;Wien;12015642;6647475;5368167;334883
2021;10;Österreich;52844278;12347540;40496738;1472801
2021;1;Burgenland;2093723;233848;1859875;58353
2021;2;Kärnten;1981348;318452;1662896;55221
2021;3;Niederösterreich;10690025;1974866;8715159;297937
2021;4;Oberösterreich;8082568;749485;7333083;225266
2021;5;Salzburg;3120176;408367;2711809;86961
2021;6;Steiermark;6962076;768623;6193453;194037
2021;7;Tirol;4928619;988424;3940195;137364
2021;8;Vorarlberg;3331638;265149;3066489;92855
2021;9;Wien;12105765;6710845;5394920;337395
2021;10;Österreich;53295938;12418059;40877879;1485389
2021;1;Burgenland;2103171;233956;1869215;58617
2021;2;Kärnten;2004568;318544;1686024;55868
2021;3;Niederösterreich;10774070;1978427;8795643;300280
2021;4;Oberösterreich;8155591;750027;7405564;227301
2021;5;Salzburg;3150244;408578;2741666;87799
2021;6;Steiermark;7035376;769039;6266337;196080
2021;7;Tirol;4937564;989483;3948081;137613
2021;8;Vorarlberg;3353242;265217;3088025;93457
2021;9;Wien;12199720;6771588;5428132;340013
2021;10;Österreich;53713546;12484859;41228687;1497028
2021;1;Burgenland;2122735;234154;1888581;59162
2021;2;Kärnten;2004600;318576;1686024;55869
2021;3;Niederösterreich;10860588;1981489;8879099;302691
2021;4;Oberösterreich;8230399;750238;7480161;229386
2021;5;Salzburg;3182300;408698;2773602;88693
2021;6;Steiermark;7108156;769214;6338942;198109
2021;7;Tirol;4945351;989855;3955496;137830
2021;8;Vorarlberg;3372599;265298;3107301;93996
2021;9;Wien;12199720;6771588;5428132;340013
2021;10;Österreich;54026448;12489110;41537338;1505749
2021;1;Burgenland;2133953;234649;1899304;59475
2021;2;Kärnten;2004662;318638;1686024;55871
2021;3;Niederösterreich;10946930;1984462;8962468;305097
2021;4;Oberösterreich;8309730;750742;7558988;231597
2021;5;Salzburg;3210537;408888;2801649;89480
2021;6;Steiermark;7168756;770261;6398495;199797
2021;7;Tirol;4953109;990375;3962734;138046
2021;8;Vorarlberg;3391186;265355;3125831;94514
2021;9;Wien;12335199;6836966;5498233;343789
2021;10;Österreich;54454062;12560336;41893726;1517667
2021;1;Burgenland;2146251;234885;1911366;59817
2021;2;Kärnten;2004843;318819;1686024;55876
2021;3;Niederösterreich;11017403;1987333;9030070;307062
2021;4;Oberösterreich;8364849;751415;7613434;233133
2021;5;Salzburg;3243318;409725;2833593;90393
2021;6;Steiermark;7229806;770916;6458890;201499
2021;7;Tirol;4959296;991365;3967931;138219
2021;8;Vorarlberg;3409273;265488;3143785;95018
2021;9;Wien;12429991;6901709;5528282;346431
2021;10;Österreich;54805030;12631655;42173375;1527449
2021;1;Burgenland;2155121;235023;1920098;60064
2021;2;Kärnten;2005306;319282;1686024;55889
2021;3;Niederösterreich;11067509;1989629;9077880;308458
2021;4;Oberösterreich;8409696;752165;7657531;234383
2021;5;Salzburg;3262409;410585;2851824;90925
2021;6;Steiermark;7293891;771642;6522249;203285
2021;7;Tirol;4964111;992145;3971966;138353
2021;8;Vorarlberg;3421341;265664;3155677;95355
2021;9;Wien;12516893;6958825;5558068;348853
2021;10;Österreich;55096277;12694960;42401317;1535566
2021;1;Burgenland;2160674;235316;1925358;60219
2021;2;Kärnten;2005566;319542;1686024;55896
2021;3;Niederösterreich;11138987;1993143;9145844;310450
2021;4;Oberösterreich;8464089;752616;7711473;235899
2021;5;Salzburg;3283950;411461;2872489;91526
2021;6;Steiermark;7342067;772364;6569703;204628
2021;7;Tirol;5066736;992840;4073896;141213
2021;8;Vorarlberg;3435819;265755;3170064;95758
2021;9;Wien;12601512;7014556;5586956;351212
2021;10;Österreich;55499400;12757593;42741807;1546801
2021;1;Burgenland;2166515;235628;1930887;60382
2021;2;Kärnten;2005704;319680;1686024;55900
2021;3;Niederösterreich;11200979;1996284;9204695;312178
2021;4;Oberösterreich;8515835;753295;7762540;237341
2021;5;Salzburg;3306333;412353;2893980;92149
2021;6;Steiermark;7389459;772916;6616543;205949
2021;7;Tirol;5073133;993638;4079495;141391
2021;8;Vorarlberg;3449291;265857;3183434;96134
2021;9;Wien;12698933;7084058;5614875;353927
2021;10;Österreich;55806182;12833709;42972473;1555351
2021;1;Burgenland;2192030;235866;1956164;61093
2021;2;Kärnten;2005838;319814;1686024;55904
2021;3;Niederösterreich;11272519;1999971;9272548;314172
2021;4;Oberösterreich;8592464;753643;7838821;239477
2021;5;Salzburg;3335947;412552;2923395;92975
2021;6;Steiermark;7464225;773219;6691006;208032
2021;7;Tirol;5083147;994120;4089027;141670
2021;8;Vorarlberg;3470674;265944;3204730;96730
2021;9;Wien;12808039;7161043;5646996;356968
2021;10;Österreich;56224883;12916172;43308711;1567021
2021;1;Burgenland;2203993;236305;1967688;61427
2021;2;Kärnten;2005860;319836;1686024;55905
2021;3;Niederösterreich;11351880;2002541;9349339;316384
2021;4;Oberösterreich;8677150;753973;7923177;241837
2021;5;Salzburg;3369518;412641;2956877;93910
2021;6;Steiermark;7538743;773354;6765389;210109
2021;7;Tirol;5091156;994389;4096767;141894
2021;8;Vorarlberg;3489689;266018;3223671;97260
2021;9;Wien;12887825;7209068;5678757;359191
2021;10;Österreich;56615814;12968125;43647689;1577916
2021;1;Burgenland;2216063;236423;1979640;61763
2021;2;Kärnten;2005946;319922;1686024;55907
2021;3;Niederösterreich;11425791;2005202;9420589;318444
2021;4;Oberösterreich;8748457;754298;7994159;243825
2021;5;Salzburg;3393921;412799;2981122;94591
2021;6;Steiermark;7588389;773842;6814547;211493
2021;7;Tirol;5098875;994733;4104142;142109
2021;8;Vorarlberg;3503656;266059;3237597;97649
2021;9;Wien;12956818;7245493;5711325;361114
2021;10;Österreich;56937916;13008771;43929145;1586893
2021;1;Burgenland;2227078;236668;1990410;62070
2021;2;Kärnten;2026456;320152;1706304;56479
2021;3;Niederösterreich;11497689;2007836;9489853;320447
2021;4;Oberösterreich;8804234;754778;8049456;245379
2021;5;Salzburg;3423985;413394;3010591;95428
2021;6;Steiermark;7642510;774070;6868440;213001
2021;7;Tirol;5105827;995267;4110560;142302
2021;8;Vorarlberg;3518471;266124;3252347;98062
2021;9;Wien;13039047;7303311;5735736;363406
2021;10;Österreich;57285297;13071600;44213697;1596575
2021;1;Burgenland;2239293;236920;2002373;62410
2021;2;Kärnten;2027343;320348;1706995;56503
2021;3;Niederösterreich;11568680;2010400;9558280;322426
2021;4;Oberösterreich;8864096;755387;8108709;247048
2021;5;Salzburg;3448373;414222;3034151;96108
2021;6;Steiermark;7707500;775864;6931636;214813
2021;7;Tirol;5111796;995934;4115862;142469
2021;8;Vorarlberg;3532307;266210;3266097;98447
2021;9;Wien;13121897;7362422;5759475;365715
2021;10;Österreich;57621285;13137707;44483578;1605939
2021;1;Burgenland;2249689;237135;2012554;62700
2021;2;Kärnten;2027526;320531;1706995;56508
2021;3;Niederösterreich;11635393;2013841;9621552;324285
2021;4;Oberösterreich;8920037;755919;8164118;248607
2021;5;Salzburg;3472626;414955;3057671;96784
2021;6;Steiermark;7760470;776493;6983977;216289
2021;7;Tirol;5184975;996493;4188482;144508
2021;8;Vorarlberg;3547051;266266;3280785;98858
2021;9;Wien;13206040;7422786;5783254;368060
2021;10;Österreich;58003807;13204419;44799388;1616600
2021;1;Burgenland;2261862;237387;2024475;63039
2021;2;Kärnten;2027616;320621;1706995;56511
2021;3;Niederösterreich;11699461;2016826;9682635;326071
2021;4;Oberösterreich;8972783;756425;8216358;250077
2021;5;Salzburg;3496858;415810;3081048;97459
2021;6;Steiermark;7819271;777047;7042224;217928
2021;7;Tirol;5192544;997236;4195308;144719
2021;8;Vorarlberg;3561206;266362;3294844;99253
2021;9;Wien;13286436;7479627;5806809;370301
2021;10;Österreich;58318037;13267341;45050696;1625358
2021;1;Burgenland;2280028;237460;2042568;63546
2021;2;Kärnten;2027758;320763;1706995;56515
2021;3;Niederösterreich;11774404;2017489;9756915;328160
2021;4;Oberösterreich;9053410;757120;8296290;252324
2021;5;Salzburg;3530403;416314;3114089;98394
2021;6;Steiermark;7898719;777484;7121235;220142
2021;7;Tirol;5203048;997909;4205139;145012
2021;8;Vorarlberg;3584352;266535;3317817;99898
2021;9;Wien;13379811;7546244;5833567;372903
2021;10;Österreich;58731933;13337318;45394615;1636894
2021;1;Burgenland;2294319;237643;2056676;63944
2021;2;Kärnten;2027837;320842;1706995;56517
2021;3;Niederösterreich;11859932;2020314;9839618;330543
2021;4;Oberösterreich;9139090;757423;8381667;254712
2021;5;Salzburg;3565844;416430;3149414;99382
2021;6;Steiermark;7976126;777627;7198499;222299
2021;7;Tirol;5213119;998284;4214835;145293
2021;8;Vorarlberg;3605956;266596;3339360;100500
2021;9;Wien;13461676;7600119;5861557;375185
2021;10;Österreich;59143899;13395278;45748621;1648375
2021;1;Burgenland;2303797;237779;2066018;64208
2021;2;Kärnten;2027934;320939;1706995;56520
2021;3;Niederösterreich;11921741;2023332;9898409;332266
2021;4;Oberösterreich;9207415;757835;8449580;256616
2021;5;Salzburg;3589262;416589;3172673;100035
2021;6;Steiermark;8025027;778071;7246956;223662
2021;7;Tirol;5221869;998904;4222965;145537
2021;8;Vorarlberg;3621793;266636;3355157;100942
2021;9;Wien;13501183;7616472;5884711;376286
2021;10;Österreich;59420021;13416557;46003464;1656071
2021;1;Burgenland;2315231;237929;2077302;64527
2021;2;Kärnten;2028134;321139;1706995;56525
2021;3;Niederösterreich;11983442;2026280;9957162;333986
2021;4;Oberösterreich;9268564;758434;8510130;258320
2021;5;Salzburg;3631403;417375;3214028;101209
2021;6;Steiermark;8091563;779339;7312224;225517
2021;7;Tirol;5230166;999697;4230469;145768
2021;8;Vorarlberg;3639021;266697;3372324;101422
2021;9;Wien;13578972;7670876;5908096;378454
2021;10;Österreich;59766496;13477766;46288730;1665728
2021;1;Burgenland;2325669;238406;2087263;64818
2021;2;Kärnten;2028258;321263;1706995;56529
2021;3;Niederösterreich;12038291;2028591;10009700;335514
2021;4;Oberösterreich;9285055;759078;8525977;258780
2021;5;Salzburg;3654719;418233;3236486;101859
2021;6;Steiermark;8160815;780031;7380784;227447
2021;7;Tirol;5237486;1000687;4236799;145972
2021;8;Vorarlberg;3652329;266788;3385541;101793
2021;9;Wien;13665654;7736770;5928884;380870
2021;10;Österreich;60048276;13549847;46498429;1673581
2021;1;Burgenland;2335203;238679;2096524;65083
2021;2;Kärnten;2412999;321788;2091211;67252
2021;3;Niederösterreich;12099340;2031797;10067543;337216
2021;4;Oberösterreich;9386949;759649;8627300;261620
2021;5;Salzburg;3681659;419082;3262577;102610
2021;6;Steiermark;8216717;780724;7435993;229005
2021;7;Tirol;5277624;1001563;4276061;147090
2021;8;Vorarlberg;3667742;266871;3400871;102222
2021;9;Wien;13699486;7755339;5944147;381813
2021;10;Österreich;60777719;13575492;47202227;1693911
2021;1;Burgenland;2345173;238833;2106340;65361
2021;2;Kärnten;2413306;322095;2091211;67260
2021;3;Niederösterreich;12154232;2034859;10119373;338746
2021;4;Oberösterreich;9448210;760236;8687974;263327
2021;5;Salzburg;3708698;420085;3288613;103364
2021;6;Steiermark;8272861;781603;7491258;230570
2021;7;Tirol;5285321;1002424;4282897;147305
2021;8;Vorarlberg;3682921;266961;3415960;102645
2021;9;Wien;13809541;7843307;5966234;384880
2021;10;Österreich;61120263;13670403;47449860;1703458
2021;1;Burgenland;2362550;238865;2123685;65846
2021;2;Kärnten;2413435;322224;2091211;67264
2021;3;Niederösterreich;12231758;2037920;10193838;340906
2021;4;Oberösterreich;9535248;760937;8774311;265753
2021;5;Salzburg;3742475;420576;3321899;104305
2021;6;Steiermark;8349779;782031;7567748;232713
2021;7;Tirol;5296672;1003518;4293154;147621
2021;8;Vorarlberg;3703578;267087;3436491;103221
2021;9;Wien;13894039;7904335;5989704;387235
2021;10;Österreich;61529534;13737493;47792041;1714864
2021;1;Burgenland;2374580;239012;2135568;66181
2021;2;Kärnten;2413518;322307;2091211;67266
2021;3;Niederösterreich;12306195;2040908;10265287;342981
2021;4;Oberösterreich;9622001;761338;8860663;268171
2021;5;Salzburg;3775832;420935;3354897;105235
2021;6;Steiermark;8422590;782535;7640055;234743
2021;7;Tirol;5306414;1004294;4302120;147893
2021;8;Vorarlberg;3723417;267196;3456221;103774
2021;9;Wien;13953387;7942197;6011190;388889
2021;10;Österreich;61897934;13780722;48117212;1725132
2021;1;Burgenland;2386653;239217;2147436;66517
2021;2;Kärnten;2413708;322497;2091211;67271
2021;3;Niederösterreich;12358842;2043991;10314851;344448
2021;4;Oberösterreich;9685060;761991;8923069;269928
2021;5;Salzburg;3796349;421279;3375070;105806
2021;6;Steiermark;8464030;783299;7680731;235898
2021;7;Tirol;5314375;1005022;4309353;148115
2021;8;Vorarlberg;3736595;267277;3469318;104141
2021;9;Wien;14004832;7971622;6033210;390323
2021;10;Österreich;62160444;13816195;48344249;1732448
2021;1;Burgenland;2396215;239366;2156849;66784
2021;2;Kärnten;2543197;322736;2220461;70880
2021;3;Niederösterreich;12412216;2047121;10365095;345936
2021;4;Oberösterreich;9741255;762746;8978509;271495
2021;5;Salzburg;3835737;422454;3413283;106904
2021;6;Steiermark;8520301;785246;7735055;237466
2021;7;Tirol;5322924;1005963;4316961;148353
2021;8;Vorarlberg;3752942;267443;3485499;104597
2021;9;Wien;14082118;8030815;6051303;392477
2021;10;Österreich;62606905;13883890;48723015;1744891
2021;1;Burgenland;2405748;239691;2166057;67050
2021;2;Kärnten;2546656;323024;2223632;70977
2021;3;Niederösterreich;12461872;2049451;10412421;347320
2021;4;Oberösterreich;9796808;763542;9033266;273043
2021;5;Salzburg;3861348;423395;3437953;107618
2021;6;Steiermark;8591433;786181;7805252;239448
2021;7;Tirol;5330439;1007018;4323421;148562
2021;8;Vorarlberg;3767898;267443;3500455;105014
2021;9;Wien;14159277;8093123;6066154;394627
2021;10;Österreich;62921479;13952868;48968611;1753659
2021;1;Burgenland;2414825;239738;2175087;67303
2021;2;Kärnten;2547004;323372;2223632;70987
2021;3;Niederösterreich;12521663;2053007;10468656;348986
2021;4;Oberösterreich;9862860;764184;9098676;274884
2021;5;Salzburg;3892072;424560;3467512;108474
2021;6;Steiermark;8648183;787097;7861086;241030
2021;7;Tirol;5358989;1008007;4350982;149358
2021;8;Vorarlberg;3785106;267791;3517315;105493
2021;9;Wien;14227187;8145617;6081570;396520
2021;10;Österreich;63257889;14013373;49244516;1763035
2021;1;Burgenland;2424732;240061;2184671;67579
2021;2;Kärnten;2547361;323729;2223632;70996
2021;3;Niederösterreich;12572713;2056124;10516589;350409
2021;4;Oberösterreich;9926548;764946;9161602;276659
2021;5;Salzburg;3920707;425123;3495584;109272
2021;6;Steiermark;8704450;792284;7912166;242598
2021;7;Tirol;5367306;1009676;4357630;149590
2021;8;Vorarlberg;3802538;268107;3534431;105979
2021;9;Wien;14305095;8207866;6097229;398691
2021;10;Österreich;63571450;14087916;49483534;1771774
2021;1;Burgenland;2438110;240126;2197984;67952
2021;2;Kärnten;2547572;323940;2223632;71002
2021;3;Niederösterreich;12647340;2059253;10588087;352489
2021;4;Oberösterreich;10010539;765655;9244884;279000
2021;5;Salzburg;3956618;425366;3531252;110273
2021;6;Steiermark;8776396;792618;7983778;244603
2021;7;Tirol;5378780;1011688;4367092;149910
2021;8;Vorarlberg;3824126;268338;3555788;106581
2021;9;Wien;14391665;8276911;6114754;401104
2021;10;Österreich;63971146;14163895;49807251;1782914
2021;1;Burgenland;2448989;240273;2208716;68255
2021;2;Kärnten;2547723;324091;2223632;71007
2021;3;Niederösterreich;12720721;2062352;10658369;354534
2021;4;Oberösterreich;10094478;766225;9328253;281339
2021;5;Salzburg;3993181;427064;3566117;111292
2021;6;Steiermark;8848634;792881;8055753;246617
2021;7;Tirol;5389026;1013502;4375524;150195
2021;8;Vorarlberg;3842369;268493;3573876;107089
2021;9;Wien;14452112;8319467;6132645;402789
2021;10;Österreich;64337233;14214348;50122885;1793117
2021;1;Burgenland;2457961;240584;2217377;68505
2021;2;Kärnten;2547930;324298;2223632;71012
2021;3;Niederösterreich;12771312;2069699;10701613;355944
2021;4;Oberösterreich;10159709;766900;9392809;283157
2021;5;Salzburg;4018368;427453;3590915;111994
2021;6;Steiermark;8894333;793660;8100673;247890
2021;7;Tirol;5396948;1014880;4382068;150416
2021;8;Vorarlberg;3854991;268686;3586305;107441
2021;9;Wien;14500388;8348769;6151619;404134
2021;10;Österreich;64601940;14254929;50347011;1800494
2021;1;Burgenland;2467595;240724;2226871;68773
2021;2;Kärnten;2597223;324530;2272693;72386
2021;3;Niederösterreich;12815697;2072222;10743475;357181
2021;4;Oberösterreich;10218447;767517;9450930;284794
2021;5;Salzburg;4056730;430467;3626263;113063
2021;6;Steiermark;8955580;796133;8159447;249597
2021;7;Tirol;5405676;1016184;4389492;150659
2021;8;Vorarlberg;3869090;268888;3600202;107834
2021;9;Wien;14569778;8403414;6166364;406068
2021;10;Österreich;64955816;14320079;50635737;1810357
2021;1;Burgenland;2480014;240965;2239049;69119
2021;2;Kärnten;2737296;324908;2412388;76290
2021;3;Niederösterreich;12863500;2075071;10788429;358513
2021;4;Oberösterreich;10274309;773644;9500665;286351
2021;5;Salzburg;4083847;432502;3651345;113819
2021;6;Steiermark;9016091;798187;8217904;251284
2021;7;Tirol;5412261;1017705;4394556;150843
2021;8;Vorarlberg;3882551;269054;3613497;108209
2021;9;Wien;14631891;8453689;6178202;407799
2021;10;Österreich;65381760;14385725;50996035;1822228
2021;1;Burgenland;2489193;241171;2248022;69375
2021;2;Kärnten;2739212;325270;2413942;76343
2021;3;Niederösterreich;12918881;2078038;10840843;360057
2021;4;Oberösterreich;10335971;774968;9561003;288070
2021;5;Salzburg;4116569;434516;3682053;114731
2021;6;Steiermark;9066752;798803;8267949;252696
2021;7;Tirol;5464071;1019261;4444810;152287
2021;8;Vorarlberg;3896921;269234;3627687;108609
2021;9;Wien;14697491;8507227;6190264;409628
2021;10;Österreich;65725061;14448488;51276573;1831796
2021;1;Burgenland;2498228;241374;2256854;69627
2021;2;Kärnten;2882705;325542;2557163;80343
2021;3;Niederösterreich;12975494;2081075;10894419;361635
2021;4;Oberösterreich;10398995;776586;9622409;289826
2021;5;Salzburg;4149240;437214;3712026;115642
2021;6;Steiermark;9117514;799207;8318307;254110
2021;7;Tirol;5487533;1021560;4465973;152941
2021;8;Vorarlberg;3913604;269403;3644201;109074
2021;9;Wien;14776429;8573421;6203008;411828
2021;10;Österreich;66199742;14525382;51674360;1845026
2021;1;Burgenland;2514970;241474;2273496;70094
2021;2;Kärnten;2895191;325795;2569396;80691
2021;3;Niederösterreich;13033212;2084344;10948868;363243
2021;4;Oberösterreich;10478249;778884;9699365;292035
2021;5;Salzburg;4185256;437214;3748042;116646
2021;6;Steiermark;9183605;799753;8383852;255952
2021;7;Tirol;5498561;1024131;4474430;153248
2021;8;Vorarlberg;3932134;269687;3662447;109591
2021;9;Wien;14846127;8628851;6217276;413770
2021;10;Österreich;66567305;14590133;51977172;1855270
2021;1;Burgenland;2525316;241713;2283603;70382
2021;2;Kärnten;2902519;326002;2576517;80895
2021;3;Niederösterreich;13095992;2087571;11008421;364993
2021;4;Oberösterreich;10554777;779348;9775429;294168
2021;5;Salzburg;4225881;442509;3783372;117778
2021;6;Steiermark;9248191;800224;8447967;257753
2021;7;Tirol;5508932;1025646;4483286;153537
2021;8;Vorarlberg;3949440;269939;3679501;110073
2021;9;Wien;14905695;8674551;6231144;415431
2021;10;Österreich;66916743;14647503;52269240;1865009
2021;1;Burgenland;2532986;241921;2291065;70596
2021;2;Kärnten;2902915;326398;2576517;80906
2021;3;Niederösterreich;13179751;2090816;11088935;367327
2021;4;Oberösterreich;10619481;782316;9837165;295971
2021;5;Salzburg;4250646;443598;3807048;118468
2021;6;Steiermark;9284259;800657;8483602;258758
2021;7;Tirol;5518936;1026954;4491982;153816
2021;8;Vorarlberg;3961420;270081;3691339;110407
2021;9;Wien;14951518;8704412;6247106;416708
2021;10;Österreich;67201912;14687153;52514759;1872957
2021;1;Burgenland;2543153;242126;2301027;70879
2021;2;Kärnten;2907120;326780;2580340;81023
2021;3;Niederösterreich;13235495;2093883;11141612;368881
2021;4;Oberösterreich;10685155;783243;9901912;297802
2021;5;Salzburg;4288787;445259;3843528;119531
2021;6;Steiermark;9338471;801324;8537147;260269
2021;7;Tirol;5528382;1028205;4500177;154079
2021;8;Vorarlberg;3976846;270252;3706594;110837
2021;9;Wien;14985021;8725260;6259761;417641
2021;10;Österreich;67488430;14716332;52772098;1880942
2021;1;Burgenland;2550682;242270;2308412;71089
2021;2;Kärnten;2908932;327062;2581870;81074
2021;3;Niederösterreich;13284346;2097066;11187280;370243
2021;4;Oberösterreich;10740863;784913;9955950;299354
2021;5;Salzburg;4317832;447376;3870456;120341
2021;6;Steiermark;9395109;801870;8593239;261847
2021;7;Tirol;5537315;1030089;4507226;154328
2021;8;Vorarlberg;3990600;270545;3720055;111220
2021;9;Wien;15045879;8774825;6271054;419338
2021;10;Österreich;67771558;14776016;52995542;1888833
2021;1;Burgenland;2558386;242569;2315817;71304
2021;2;Kärnten;3046545;327418;2719127;84909
2021;3;Niederösterreich;13346139;2100863;11245276;371965
2021;4;Oberösterreich;10803193;786451;10016742;301091
2021;5;Salzburg;4351539;449624;3901915;121280
2021;6;Steiermark;9453147;813511;8639636;263465
2021;7;Tirol;5559791;1031508;4528283;154955
2021;8;Vorarlberg;4005664;270781;3734883;111640
2021;9;Wien;15112334;8829708;6282626;421190
2021;10;Österreich;68236738;14852433;53384305;1901798
2021;1;Burgenland;2566695;242781;2323914;71535
2021;2;Kärnten;3046935;327808;2719127;84920
2021;3;Niederösterreich;13393116;2104308;11288808;373274
2021;4;Oberösterreich;10860034;787772;10072262;302676
2021;5;Salzburg;4383628;452698;3930930;122174
2021;6;Steiermark;9501102;817289;8683813;264801
2021;7;Tirol;5569850;1033647;4536203;155235
2021;8;Vorarlberg;4020521;270944;3749577;112054
2021;9;Wien;15183652;8889189;6294463;423177
2021;10;Österreich;68525533;14926436;53599097;1909847
2021;1;Burgenland;2577995;242918;2335077;71850
2021;2;Kärnten;3059190;329341;2729849;85261
2021;3;Niederösterreich;13461545;2107850;11353695;375181
2021;4;Oberösterreich;10932246;789874;10142372;304688
2021;5;Salzburg;4425367;456613;3968754;123338
2021;6;Steiermark;9568400;820685;8747715;266677
2021;7;Tirol;5592467;1036887;4555580;155865
2021;8;Vorarlberg;4039944;271162;3768782;112596
2021;9;Wien;15279536;8971580;6307956;425850
2021;10;Österreich;68936690;15026910;53909780;1921306
2021;1;Burgenland;2588272;243068;2345204;72137
2021;2;Kärnten;3059329;329480;2729849;85265
2021;3;Niederösterreich;13532624;2111020;11421604;377162
2021;4;Oberösterreich;11009949;790465;10219484;306854
2021;5;Salzburg;4466674;458900;4007774;124489
2021;6;Steiermark;9638965;823434;8815531;268644
2021;7;Tirol;5604332;1038329;4566003;156196
2021;8;Vorarlberg;4057687;271381;3786306;113090
2021;9;Wien;15325371;9007143;6318228;427127
2021;10;Österreich;69283203;15073220;54209983;1930964
2021;1;Burgenland;2596181;243233;2352948;72357
2021;2;Kärnten;3059995;329710;2730285;85284
2021;3;Niederösterreich;13586145;2113979;11472166;378654
2021;4;Oberösterreich;11071913;791205;10280708;308581
2021;5;Salzburg;4492570;460177;4032393;125211
2021;6;Steiermark;9678241;825746;8852495;269738
2021;7;Tirol;5614835;1039568;4575267;156489
2021;8;Vorarlberg;4070505;271502;3799003;113447
2021;9;Wien;15367560;9032610;6334950;428303
2021;10;Österreich;69537945;15107730;54430215;1938064
2021;1;Burgenland;2614580;249486;2365094;72870
2021;2;Kärnten;3061590;330028;2731562;85328
2021;3;Niederösterreich;13638914;2117382;11521532;380125
2021;4;Oberösterreich;11127656;794543;10333113;310134
2021;5;Salzburg;4529397;461390;4068007;126237
2021;6;Steiermark;9731220;826412;8904808;271215
2021;7;Tirol;5624683;1041240;4583443;156763
2021;8;Vorarlberg;4086025;271810;3814215;113880
2021;9;Wien;15430120;9083710;6346410;430047
2021;10;Österreich;69844185;15176001;54668184;1946599
2021;1;Burgenland;2622128;249719;2372409;73080
2021;2;Kärnten;3063941;331229;2732712;85394
2021;3;Niederösterreich;13651107;2120899;11530208;380464
2021;4;Oberösterreich;11188620;796294;10392326;311833
2021;5;Salzburg;4560633;463981;4096652;127108
2021;6;Steiermark;9789618;828609;8961009;272842
2021;7;Tirol;5633620;1042840;4590780;157012
2021;8;Vorarlberg;4101094;272053;3829041;114300
2021;9;Wien;15497838;9141255;6356583;431934
2021;10;Österreich;70108599;15246879;54861720;1953968
2021;1;Burgenland;2630247;250367;2379880;73307
2021;2;Kärnten;3207020;330709;2876311;89382
2021;3;Niederösterreich;13714222;2125346;11588876;382223
2021;4;Oberösterreich;11253459;797131;10456328;313641
2021;5;Salzburg;4593615;466067;4127548;128027
2021;6;Steiermark;9840551;832242;9008309;274262
2021;7;Tirol;5643314;1044408;4598906;157282
2021;8;Vorarlberg;4118207;272184;3846023;114777
2021;9;Wien;15555771;9188579;6367192;433549
2021;10;Österreich;70556406;15307033;55249373;1966449
2021;1;Burgenland;2638633;250781;2387852;73540
2021;2;Kärnten;3207297;330986;2876311;89389
2021;3;Niederösterreich;13751787;2128705;11623082;383270
2021;4;Oberösterreich;11314138;798941;10515197;315332
2021;5;Salzburg;4627285;468759;4158526;128965
2021;6;Steiermark;9892971;834266;9058705;275723
2021;7;Tirol;5653660;1046529;4607131;157571
2021;8;Vorarlberg;4135620;272557;3863063;115262
2021;9;Wien;15615562;9237462;6378100;435215
2021;10;Österreich;70836953;15368986;55467967;1974268
2021;1;Burgenland;2651738;251582;2400156;73906
2021;2;Kärnten;3217965;331428;2886537;89687
2021;3;Niederösterreich;13834722;2132043;11702679;385582
2021;4;Oberösterreich;11390158;800816;10589342;317450
2021;5;Salzburg;4668324;472374;4195950;130109
2021;6;Steiermark;9919930;837728;9082202;276474
2021;7;Tirol;5668155;1049813;4618342;157975
2021;8;Vorarlberg;4155974;272894;3883080;115829
2021;9;Wien;15674778;9284063;6390715;436865
2021;10;Österreich;71181744;15432741;55749003;1983877
2021;1;Burgenland;2660989;251750;2409239;74163
2021;2;Kärnten;3218159;331622;2886537;89692
2021;3;Niederösterreich;13904982;2135414;11769568;387540
2021;4;Oberösterreich;11472878;801618;10671260;319756
2021;5;Salzburg;4709322;475306;4234016;131252
2021;6;Steiermark;10022024;838434;9183590;279320
2021;7;Tirol;5679969;1051270;4628699;158304
2021;8;Vorarlberg;4176627;273102;3903525;116405
2021;9;Wien;15732499;9327795;6404704;438474
2021;10;Österreich;71577449;15486311;56091138;1994906
2021;1;Burgenland;2667981;251798;2416183;74358
2021;2;Kärnten;3219312;331838;2887474;89724
2021;3;Niederösterreich;13967558;2138492;11829066;389284
2021;4;Oberösterreich;11546843;802502;10744341;321817
2021;5;Salzburg;4738848;476897;4261951;132074
2021;6;Steiermark;10065896;839335;9226561;280542
2021;7;Tirol;5689506;1052588;4636918;158570
2021;8;Vorarlberg;4193271;273310;3919961;116869
2021;9;Wien;15778635;9357363;6421272;439760
2021;10;Österreich;71867850;15524123;56343727;2002999
2021;1;Burgenland;2676535;251981;2424554;74597
2021;2;Kärnten;3223416;333567;2889849;89839
2021;3;Niederösterreich;14017921;2143840;11874081;390688
2021;4;Oberösterreich;11595901;806329;10789572;323185
2021;5;Salzburg;4775135;477947;4297188;133086
2021;6;Steiermark;10120285;842529;9277756;282058
2021;7;Tirol;5699270;1054546;4644724;158842
2021;8;Vorarlberg;4206607;273679;3932928;117241
2021;9;Wien;15840185;9407163;6433022;441475
2021;10;Österreich;72155255;15591581;56563674;2011010
2021;1;Burgenland;2682806;252170;2430636;74771
2021;2;Kärnten;3225966;333954;2892012;89910
2021;3;Niederösterreich;14065720;2147118;11918602;392020
2021;4;Oberösterreich;11651463;807942;10843521;324733
2021;5;Salzburg;4805291;481082;4324209;133926
2021;6;Steiermark;10150988;846800;9304188;282914
2021;7;Tirol;5719893;1056337;4663556;159417
2021;8;Vorarlberg;4219886;274051;3945835;117611
2021;9;Wien;15902874;9460930;6441944;443222
2021;10;Österreich;72424887;15660384;56764503;2018524
2021;1;Burgenland;2691302;253594;2437708;75008
2021;2;Kärnten;3378769;334201;3044568;94168
2021;3;Niederösterreich;14113145;2150790;11962355;393342
2021;4;Oberösterreich;11703674;809802;10893872;326188
2021;5;Salzburg;4835629;483640;4351989;134772
2021;6;Steiermark;10218867;849101;9369766;284806
2021;7;Tirol;5729581;1058188;4671393;159687
2021;8;Vorarlberg;4234426;274419;3960007;118016
2021;9;Wien;15962352;9511109;6451243;444880
2021;10;Österreich;72867745;15724844;57142901;2030867
2021;1;Burgenland;2698360;254028;2444332;75205
2021;2;Kärnten;3379163;334595;3044568;94179
2021;3;Niederösterreich;14165204;2153997;12011207;394793
2021;4;Oberösterreich;11763943;811794;10952149;327868
2021;5;Salzburg;4865916;486038;4379878;135616
2021;6;Steiermark;10266082;854801;9411281;286122
2021;7;Tirol;5739151;1060703;4678448;159954
2021;8;Vorarlberg;4249482;274819;3974663;118436
2021;9;Wien;16009055;9548612;6460443;446182
2021;10;Österreich;73136356;15779387;57356969;2038353
2021;1;Burgenland;2708133;254544;2453589;75477
2021;2;Kärnten;3389743;336105;3053638;94474
2021;3;Niederösterreich;14229083;2157296;12071787;396573
2021;4;Oberösterreich;11836158;814346;11021812;329881
2021;5;Salzburg;4905441;490341;4415100;136718
2021;6;Steiermark;10322177;858721;9463456;287685
2021;7;Tirol;5751320;1063064;4688256;160293
2021;8;Vorarlberg;4267729;274819;3992910;118944
2021;9;Wien;16092764;9622012;6470752;448515
2021;10;Österreich;73502548;15871248;57631300;2048559
2021;1;Burgenland;2717628;255519;2462109;75742
2021;2;Kärnten;3389994;336356;3053638;94481
2021;3;Niederösterreich;14300736;2160989;12139747;398570
2021;4;Oberösterreich;11915126;815038;11100088;332082
2021;5;Salzburg;4943735;492689;4451046;137785
2021;6;Steiermark;10392712;862131;9530581;289651
2021;7;Tirol;5762047;1064884;4697163;160592
2021;8;Vorarlberg;4286911;275605;4011306;119479
2021;9;Wien;16123745;9642059;6481686;449378
2021;10;Österreich;73832634;15905270;57927364;2057759
2021;1;Burgenland;2725221;256165;2469056;75954
2021;2;Kärnten;3390884;336648;3054236;94506
2021;3;Niederösterreich;14356398;2164121;12192277;400121
2021;4;Oberösterreich;11977725;816026;11161699;333826
2021;5;Salzburg;4967645;494187;4473458;138451
2021;6;Steiermark;10435287;864432;9570855;290838
2021;7;Tirol;5770965;1066257;4704708;160840
2021;8;Vorarlberg;4297871;275938;4021933;119784
2021;9;Wien;16194692;9699373;6495319;451356
2021;10;Österreich;74116688;15973147;58143541;2065676
2021;1;Burgenland;2732941;256812;2476129;76169
2021;2;Kärnten;3396393;336959;3059434;94659
2021;3;Niederösterreich;14404229;2167317;12236912;401454
2021;4;Oberösterreich;12026117;820304;11205813;335175
2021;5;Salzburg;5007198;495771;4511427;139554
2021;6;Steiermark;10485451;868006;9617445;292236
2021;7;Tirol;5779559;1068110;4711449;161080
2021;8;Vorarlberg;4311342;276344;4034998;120160
2021;9;Wien;16251445;9745848;6505597;452937
2021;10;Österreich;74394675;16035471;58359204;2073423
2021;1;Burgenland;2739606;257198;2482408;76354
2021;2;Kärnten;3397100;337517;3059583;94679
2021;3;Niederösterreich;14445035;2170907;12274128;402592
2021;4;Oberösterreich;12079011;822287;11256724;336649
2021;5;Salzburg;5033576;498550;4535026;140289
2021;6;Steiermark;10538602;870756;9667846;293717
2021;7;Tirol;5799365;1069988;4729377;161632
2021;8;Vorarlberg;4324131;276797;4047334;120516
2021;9;Wien;16319694;9806122;6513572;454840
2021;10;Österreich;74676120;16110122;58565998;2081268
2021;1;Burgenland;2747484;258583;2488901;76574
2021;2;Kärnten;3540847;338153;3202694;98685
2021;3;Niederösterreich;14499652;2175548;12324104;404114
2021;4;Oberösterreich;12138214;824221;11313993;338299
2021;5;Salzburg;5063528;501422;4562106;141124
2021;6;Steiermark;10579866;872645;9707221;294867
2021;7;Tirol;5807109;1071586;4735523;161848
2021;8;Vorarlberg;4338518;277079;4061439;120917
2021;9;Wien;16383636;9861724;6521912;456622
2021;10;Österreich;75098854;16180961;58917893;2093049
2021;1;Burgenland;2753733;258741;2494992;76748
2021;2;Kärnten;3541283;338589;3202694;98698
2021;3;Niederösterreich;14548224;2179571;12368653;405468
2021;4;Oberösterreich;12188246;826471;11361775;339694
2021;5;Salzburg;5091560;504698;4586862;141905
2021;6;Steiermark;10621052;875116;9745936;296015
2021;7;Tirol;5815012;1073533;4741479;162068
2021;8;Vorarlberg;4351614;277504;4074110;121282
2021;9;Wien;16443577;9913881;6529696;458292
2021;10;Österreich;75354301;16248104;59106197;2100169
2021;1;Burgenland;2767135;259888;2507247;77122
2021;2;Kärnten;3550900;340172;3210728;98966
2021;3;Niederösterreich;14590193;2182998;12407195;406637
2021;4;Oberösterreich;12256025;829223;11426802;341583
2021;5;Salzburg;5127916;509476;4618440;142918
2021;6;Steiermark;10680986;881220;9799766;297685
2021;7;Tirol;5826704;1076411;4750293;162394
2021;8;Vorarlberg;4368825;277967;4090858;121762
2021;9;Wien;16512041;9973082;6538959;460200
2021;10;Österreich;75680725;16330437;59350288;2109266
2021;1;Burgenland;2776125;261407;2514718;77372
2021;2;Kärnten;3551153;340425;3210728;98973
2021;3;Niederösterreich;14676731;2186330;12490401;409049
2021;4;Oberösterreich;12329559;830363;11499196;343632
2021;5;Salzburg;5161226;512543;4648683;143846
2021;6;Steiermark;10736277;884768;9851509;299226
2021;7;Tirol;5836199;1078478;4757721;162658
2021;8;Vorarlberg;4384792;278265;4106527;122207
2021;9;Wien;16560946;10011858;6549088;461563
2021;10;Österreich;76013008;16384437;59628571;2118527
2021;1;Burgenland;2782931;262191;2520740;77562
2021;2;Kärnten;3551767;340728;3211039;98990
2021;3;Niederösterreich;14729499;2189388;12540111;410520
2021;4;Oberösterreich;12388346;831486;11556860;345271
2021;5;Salzburg;5182671;513953;4668718;144444
2021;6;Steiermark;10771540;887221;9884319;300209
2021;7;Tirol;5843541;1079800;4763741;162863
2021;8;Vorarlberg;4395094;278633;4116461;122494
2021;9;Wien;16598253;10037173;6561080;462603
2021;10;Österreich;76243642;16420573;59823069;2124955
2021;1;Burgenland;2791257;262780;2528477;77794
2021;2;Kärnten;3555562;341027;3214535;99096
2021;3;Niederösterreich;14777235;2192341;12584894;411850
2021;4;Oberösterreich;12437817;836309;11601508;346649
2021;5;Salzburg;5219203;515770;4703433;145462
2021;6;Steiermark;10816555;888150;9928405;301464
2021;7;Tirol;5850693;1081410;4769283;163062
2021;8;Vorarlberg;4407614;278973;4128641;122843
2021;9;Wien;16662168;10089268;6572900;464384
2021;10;Österreich;76518104;16486028;60032076;2132605
2021;1;Burgenland;2797907;263853;2534054;77979
2021;2;Kärnten;3557341;341634;3215707;99145
2021;3;Niederösterreich;14818665;2195629;12623036;413005
2021;4;Oberösterreich;12490663;838414;11652249;348122
2021;5;Salzburg;5240788;517639;4723149;146064
2021;6;Steiermark;10867138;890514;9976624;302874
2021;7;Tirol;5868409;1083315;4785094;163556
2021;8;Vorarlberg;4419510;279489;4140021;123174
2021;9;Wien;16740110;10157566;6582544;466557
2021;10;Österreich;76800531;16568053;60232478;2140476
2021;1;Burgenland;2805262;265042;2540220;78184
2021;2;Kärnten;3686589;342236;3344353;102747
2021;3;Niederösterreich;14872582;2200011;12672571;414508
2021;4;Oberösterreich;12549881;840400;11709481;349773
2021;5;Salzburg;5266876;520360;4746516;146791
2021;6;Steiermark;10908389;892773;10015616;304023
2021;7;Tirol;5875375;1085053;4790322;163750
2021;8;Vorarlberg;4433126;280014;4153112;123554
2021;9;Wien;16813682;10220749;6592933;468607
2021;10;Österreich;77211762;16646638;60565124;2151937
2021;1;Burgenland;2811914;265674;2546240;78370
2021;2;Kärnten;3687129;342776;3344353;102762
2021;3;Niederösterreich;14919964;2203185;12716779;415828
2021;4;Oberösterreich;12603638;842613;11761025;351271
2021;5;Salzburg;5293323;523581;4769742;147528
2021;6;Steiermark;10948991;895159;10053832;305155
2021;7;Tirol;5882619;1087634;4794985;163952
2021;8;Vorarlberg;4446862;280427;4166435;123937
2021;9;Wien;16881522;10277654;6603868;470498
2021;10;Österreich;77475962;16718703;60757259;2159301
2021;1;Burgenland;2825467;266100;2559367;78747
2021;2;Kärnten;3701932;350963;3350969;103175
2021;3;Niederösterreich;14963543;2207262;12756281;417043
2021;4;Oberösterreich;12676299;845928;11830371;353296
2021;5;Salzburg;5326339;527454;4798885;148448
2021;6;Steiermark;11010278;902580;10107698;306863
2021;7;Tirol;5893205;1091309;4801896;164247
2021;8;Vorarlberg;4464368;280922;4183446;124425
2021;9;Wien;16956910;10341325;6615585;472599
2021;10;Österreich;77818341;16813843;61004498;2168843
2021;1;Burgenland;2835065;267606;2567459;79015
2021;2;Kärnten;3702223;351254;3350969;103183
2021;3;Niederösterreich;15032471;2210822;12821649;418964
2021;4;Oberösterreich;12755775;847308;11908467;355511
2021;5;Salzburg;5362486;531148;4831338;149456
2021;6;Steiermark;11070337;906404;10163933;308537
2021;7;Tirol;5901265;1092981;4808284;164472
2021;8;Vorarlberg;4481532;281300;4200232;124903
2021;9;Wien;17052586;10423231;6629355;475266
2021;10;Österreich;78193740;16912054;61281686;2179306
2021;1;Burgenland;2844120;268589;2575531;79267
2021;2;Kärnten;3703069;351705;3351364;103207
2021;3;Niederösterreich;15097093;2214319;12882774;420765
2021;4;Oberösterreich;12830369;848627;11981742;357590
2021;5;Salzburg;5388947;532576;4856371;150193
2021;6;Steiermark;11112595;909278;10203317;309715
2021;7;Tirol;5908465;1094326;4814139;164672
2021;8;Vorarlberg;4496658;281634;4215024;125325
2021;9;Wien;17150535;10501894;6648641;477996
2021;10;Österreich;78531851;17002948;61528903;2188729
2021;1;Burgenland;2853390;269655;2583735;79526
2021;2;Kärnten;3707505;352327;3355178;103330
2021;3;Niederösterreich;15150101;2218030;12932071;422242
2021;4;Oberösterreich;12883992;852084;12031908;359084
2021;5;Salzburg;5418004;534131;4883873;151003
2021;6;Steiermark;11182508;917312;10265196;311663
2021;7;Tirol;5915733;1096398;4819335;164875
2021;8;Vorarlberg;4510221;282042;4228179;125703
2021;9;Wien;17248954;10588587;6660367;480739
2021;10;Österreich;78870408;17110566;61759842;2198165
2021;1;Burgenland;2858841;271129;2587712;79678
2021;2;Kärnten;3840576;352893;3487683;107039
2021;3;Niederösterreich;15198301;2221480;12976821;423586
2021;4;Oberösterreich;12936963;854796;12082167;360561
2021;5;Salzburg;5441668;537134;4904534;151662
2021;6;Steiermark;11217622;920809;10296813;312642
2021;7;Tirol;5925376;1098157;4827219;165144
2021;8;Vorarlberg;4523231;282653;4240578;126065
2021;9;Wien;17367605;10695047;6672558;484045
2021;10;Österreich;79310183;17234098;62076085;2210422
2021;1;Burgenland;2867134;272085;2595049;79909
2021;2;Kärnten;3842540;353510;3489030;107094
2021;3;Niederösterreich;15238118;2225814;13012304;424695
2021;4;Oberösterreich;13001691;857387;12144304;362365
2021;5;Salzburg;5467216;539784;4927432;152375
2021;6;Steiermark;11265180;924005;10341175;313967
2021;7;Tirol;5931750;1099757;4831993;165321
2021;8;Vorarlberg;4538355;283426;4254929;126487
2021;9;Wien;17506168;10821070;6685098;487907
2021;10;Österreich;79658152;17376838;62281314;2220120
2021;1;Burgenland;2873236;272996;2600240;80079
2021;2;Kärnten;3843819;354038;3489781;107130
2021;3;Niederösterreich;15285816;2229472;13056344;426025
2021;4;Oberösterreich;13061523;860541;12200982;364032
2021;5;Salzburg;5493594;542880;4950714;153110
2021;6;Steiermark;11304991;926539;10378452;315077
2021;7;Tirol;5939411;1103044;4836367;165535
2021;8;Vorarlberg;4551504;283881;4267623;126853
2021;9;Wien;17625888;10928876;6697012;491244
2021;10;Österreich;79979782;17502267;62477515;2229084
2021;1;Burgenland;2880690;273144;2607546;80287
2021;2;Kärnten;3851122;355417;3495705;107333
2021;3;Niederösterreich;15342012;2234041;13107971;427591
2021;4;Oberösterreich;13138276;863137;12275139;366172
2021;5;Salzburg;5526177;547142;4979035;154018
2021;6;Steiermark;11358663;932408;10426255;316573
2021;7;Tirol;5949093;1106795;4842298;165805
2021;8;Vorarlberg;4568700;284391;4284309;127332
2021;9;Wien;17723160;11013701;6709459;493955
2021;10;Österreich;80337893;17610176;62727717;2239064
2021;1;Burgenland;2889014;273488;2615526;80519
2021;2;Kärnten;3851520;355815;3495705;107344
2021;3;Niederösterreich;15407640;2237753;13169887;429420
2021;4;Oberösterreich;13221225;864795;12356430;368483
2021;5;Salzburg;5559709;550640;5009069;154952
2021;6;Steiermark;11426338;937264;10489074;318459
2021;7;Tirol;5956966;1109155;4847811;166024
2021;8;Vorarlberg;4586603;284893;4301710;127831
2021;9;Wien;17803827;11078260;6725567;496203
2021;10;Österreich;80702842;17692063;63010779;2249236
2021;1;Burgenland;2895490;273687;2621803;80699
2021;2;Kärnten;3857313;361608;3495705;107506
2021;3;Niederösterreich;15460967;2241392;13219575;430906
2021;4;Oberösterreich;13302164;869805;12432359;370739
2021;5;Salzburg;5585979;552781;5033198;155685
2021;6;Steiermark;11471183;941549;10529634;319709
2021;7;Tirol;5965190;1111263;4853927;166253
2021;8;Vorarlberg;4601788;285285;4316503;128255
2021;9;Wien;17872699;11131021;6741678;498123
2021;10;Österreich;81012773;17768391;63244382;2257874
2021;1;Burgenland;2906451;274021;2632430;81005
2021;2;Kärnten;3861808;362226;3499582;107631
2021;3;Niederösterreich;15509008;2245844;13263164;432245
2021;4;Oberösterreich;13372107;872654;12499453;372689
2021;5;Salzburg;5618942;554660;5064282;156603
2021;6;Steiermark;11510049;942403;10567646;320792
2021;7;Tirol;5971965;1114019;4857946;166442
2021;8;Vorarlberg;4616445;286038;4330407;128663
2021;9;Wien;18017091;11267442;6749649;502147
2021;10;Österreich;81383866;17919307;63464559;2268216
2021;1;Burgenland;2915519;277897;2637622;81257
2021;2;Kärnten;3864029;363110;3500919;107693
2021;3;Niederösterreich;15553618;2249898;13303720;433489
2021;4;Oberösterreich;13423100;875555;12547545;374110
2021;5;Salzburg;5640362;557986;5082376;157200
2021;6;Steiermark;11574038;950622;10623416;322575
2021;7;Tirol;5992795;1116592;4876203;167023
2021;8;Vorarlberg;4627701;286496;4341205;128977
2021;9;Wien;18146551;11390472;6756079;505755
2021;10;Österreich;81737713;18068628;63669085;2278078
2021;1;Burgenland;2922746;279109;2643637;81459
2021;2;Kärnten;4004331;363825;3640506;111603
2021;3;Niederösterreich;15598225;2255225;13343000;434732
2021;4;Oberösterreich;13481486;879218;12602268;375737
2021;5;Salzburg;5663987;561938;5102049;157859
2021;6;Steiermark;11610283;954459;10655824;323585
2021;7;Tirol;5999538;1119307;4880231;167211
2021;8;Vorarlberg;4640182;287057;4353125;129325
2021;9;Wien;18295685;11534115;6761570;509912
2021;10;Österreich;82216463;18234253;63982210;2291421
2021;1;Burgenland;2929891;280061;2649830;81658
2021;2;Kärnten;4004956;364450;3640506;111620
2021;3;Niederösterreich;15625235;2259723;13365512;435485
2021;4;Oberösterreich;13530231;882165;12648066;377096
2021;5;Salzburg;5685658;565389;5120269;158463
2021;6;Steiermark;11646807;960983;10685824;324603
2021;7;Tirol;6007686;1123382;4884304;167438
2021;8;Vorarlberg;4651945;287914;4364031;129652
2021;9;Wien;18418311;11651524;6766787;513329
2021;10;Österreich;82500720;18375591;64125129;2299344
2021;1;Burgenland;2943253;281509;2661744;82030
2021;2;Kärnten;4014463;368675;3645788;111885
2021;3;Niederösterreich;15686855;2265488;13421367;437202
2021;4;Oberösterreich;13589794;887621;12702173;378756
2021;5;Salzburg;5715099;570510;5144589;159283
2021;6;Steiermark;11694848;967024;10727824;325942
2021;7;Tirol;6017534;1128333;4889201;167712
2021;8;Vorarlberg;4667485;288710;4378775;130086
2021;9;Wien;18539101;11766765;6772336;516696
2021;10;Österreich;82868432;18524635;64343797;2309592
2021;1;Burgenland;2951861;283036;2668825;82270
2021;2;Kärnten;4014910;369122;3645788;111898
2021;3;Niederösterreich;15751164;2270494;13480670;438994
2021;4;Oberösterreich;13684123;891668;12792455;381385
2021;5;Salzburg;5752384;575736;5176648;160322
2021;6;Steiermark;11753219;974140;10779079;327569
2021;7;Tirol;6025767;1130636;4895131;167942
2021;8;Vorarlberg;4685680;289032;4396648;130593
2021;9;Wien;18623646;11843240;6780406;519052
2021;10;Österreich;83242754;18627104;64615650;2320025
2021;1;Burgenland;2959636;285237;2674399;82487
2021;2;Kärnten;4015445;369657;3645788;111913
2021;3;Niederösterreich;15803736;2275813;13527923;440459
2021;4;Oberösterreich;13757744;895127;12862617;383436
2021;5;Salzburg;5779669;579173;5200496;161083
2021;6;Steiermark;11787037;975529;10811508;328512
2021;7;Tirol;6034421;1133499;4900922;168183
2021;8;Vorarlberg;4697416;289799;4407617;130920
2021;9;Wien;18687051;11897395;6789656;520819
2021;10;Österreich;83522155;18701229;64820926;2327812
2021;1;Burgenland;2968311;286747;2681564;82729
2021;2;Kärnten;4022729;370339;3652390;112116
2021;3;Niederösterreich;15846419;2280107;13566312;441649
2021;4;Oberösterreich;13811345;898369;12912976;384930
2021;5;Salzburg;5807107;581042;5226065;161847
2021;6;Steiermark;11825291;981896;10843395;329578
2021;7;Tirol;6041289;1136484;4904805;168374
2021;8;Vorarlberg;4710804;290389;4420415;131293
2021;9;Wien;18751286;11955040;6796246;522609
2021;10;Österreich;83784581;18780413;65004168;2335126
2021;1;Burgenland;2974163;287553;2686610;82892
2021;2;Kärnten;4024379;371185;3653194;112162
2021;3;Niederösterreich;15890440;2284896;13605544;442876
2021;4;Oberösterreich;13859689;901590;12958099;386278
2021;5;Salzburg;5832225;586218;5246007;162548
2021;6;Steiermark;11900088;997286;10902802;331662
2021;7;Tirol;6048221;1139936;4908285;168567
2021;8;Vorarlberg;4722817;291347;4431470;131628
2021;9;Wien;18980544;12177800;6802744;528999
2021;10;Österreich;84232566;19037811;65194755;2347611
2021;1;Burgenland;2981986;290042;2691944;83110
2021;2;Kärnten;4163946;371989;3791957;116052
2021;3;Niederösterreich;15930817;2291248;13639569;444001
2021;4;Oberösterreich;13918895;906052;13012843;387928
2021;5;Salzburg;5856754;590898;5265856;163231
2021;6;Steiermark;11936660;1003772;10932888;332682
2021;7;Tirol;6065291;1142628;4922663;169043
2021;8;Vorarlberg;4735522;291932;4443590;131982
2021;9;Wien;19140051;12330970;6809081;533445
2021;10;Österreich;84729922;19219531;65510391;2361473
2021;1;Burgenland;2987236;290344;2696892;83256
2021;2;Kärnten;4164685;372728;3791957;116072
2021;3;Niederösterreich;15974469;2297601;13676868;445218
2021;4;Oberösterreich;13969796;909852;13059944;389346
2021;5;Salzburg;5881138;594831;5286307;163911
2021;6;Steiermark;11972366;1009165;10963201;333677
2021;7;Tirol;6073232;1146521;4926711;169265
2021;8;Vorarlberg;4748328;292436;4455892;132339
2021;9;Wien;19262797;12447057;6815740;536866
2021;10;Österreich;85034047;19360535;65673512;2369949
2021;1;Burgenland;3000453;292680;2707773;83624
2021;2;Kärnten;4174731;377647;3797084;116352
2021;3;Niederösterreich;16023008;2302922;13720086;446571
2021;4;Oberösterreich;14031301;913279;13118022;391061
2021;5;Salzburg;5918756;601797;5316959;164959
2021;6;Steiermark;12023418;1019920;11003498;335100
2021;7;Tirol;6083368;1152021;4931347;169547
2021;8;Vorarlberg;4763825;293203;4470622;132771
2021;9;Wien;19368100;12545494;6822606;539800
2021;10;Österreich;85386960;19498963;65887997;2379785
2021;1;Burgenland;3007975;294026;2713949;83834
2021;2;Kärnten;4175177;378093;3797084;116365
2021;3;Niederösterreich;16083856;2308756;13775100;448267
2021;4;Oberösterreich;14108087;914992;13193095;393201
2021;5;Salzburg;5954909;605909;5349000;165967
2021;6;Steiermark;12082806;1028479;11054327;336755
2021;7;Tirol;6092228;1155433;4936795;169794
2021;8;Vorarlberg;4781858;293847;4488011;133273
2021;9;Wien;19450233;12618771;6831462;542089
2021;10;Österreich;85737129;19598306;66138823;2389544
2021;1;Burgenland;3015843;295776;2720067;84053
2021;2;Kärnten;4175823;378739;3797084;116383
2021;3;Niederösterreich;16139866;2314037;13825829;449828
2021;4;Oberösterreich;14181581;916884;13264697;395249
2021;5;Salzburg;5983335;608927;5374408;166759
2021;6;Steiermark;12125933;1035326;11090607;337957
2021;7;Tirol;6100023;1157993;4942030;170011
2021;8;Vorarlberg;4794499;294400;4500099;133626
2021;9;Wien;19516672;12674304;6842368;543941
2021;10;Österreich;86033575;19676386;66357189;2397806
2021;1;Burgenland;3024110;297528;2726582;84284
2021;2;Kärnten;4182277;379595;3802682;116563
2021;3;Niederösterreich;16181333;2319682;13861651;450983
2021;4;Oberösterreich;14236904;925717;13311187;396791
2021;5;Salzburg;6011103;610839;5400264;167533
2021;6;Steiermark;12158956;1037993;11120963;338877
2021;7;Tirol;6107191;1161353;4945838;170211
2021;8;Vorarlberg;4807727;294789;4512938;133994
2021;9;Wien;19682253;12833788;6848465;548556
2021;10;Österreich;86391854;19861284;66530570;2407792
2021;1;Burgenland;3029278;298055;2731223;84428
2021;2;Kärnten;4183171;380489;3802682;116587
2021;3;Niederösterreich;16223977;2325270;13898707;452172
2021;4;Oberösterreich;14286405;929557;13356848;398171
2021;5;Salzburg;6034617;615722;5418895;168188
2021;6;Steiermark;12233342;1050386;11182956;340950
2021;7;Tirol;6129012;1166760;4962252;170819
2021;8;Vorarlberg;4819101;295627;4523474;134311
2021;9;Wien;19812048;12951172;6860876;552173
2021;10;Österreich;86750951;20013038;66737913;2417800
2021;1;Burgenland;3037057;300556;2736501;84645
2021;2;Kärnten;4294149;381116;3913033;119680
2021;3;Niederösterreich;16264417;2331742;13932675;453299
2021;4;Oberösterreich;14343254;933742;13409512;399755
2021;5;Salzburg;6056128;619411;5436717;168788
2021;6;Steiermark;12269782;1058169;11211613;341966
2021;7;Tirol;6135526;1169775;4965751;171001
2021;8;Vorarlberg;4831072;296154;4534918;134645
2021;9;Wien;19953434;13079984;6873450;556114
2021;10;Österreich;87184819;20170649;67014170;2429892
2021;1;Burgenland;3042929;301816;2741113;84808
2021;2;Kärnten;4295428;382276;3913152;119716
2021;3;Niederösterreich;16297684;2336960;13960724;454226
2021;4;Oberösterreich;14391026;938123;13452903;401086
2021;5;Salzburg;6077355;623272;5454083;169379
2021;6;Steiermark;12305676;1063795;11241881;342966
2021;7;Tirol;6140747;1171780;4968967;171146
2021;8;Vorarlberg;4843066;296776;4546290;134979
2021;9;Wien;20081163;13195914;6885249;559674
2021;10;Österreich;87475074;20310712;67164362;2437982
2021;1;Burgenland;3052943;303204;2749739;85087
2021;2;Kärnten;4305323;387309;3918014;119992
2021;3;Niederösterreich;16347863;2342675;14005188;455625
2021;4;Oberösterreich;14448973;942008;13506965;402701
2021;5;Salzburg;6103600;628117;5475483;170111
2021;6;Steiermark;12352857;1072094;11280763;344281
2021;7;Tirol;6150199;1175835;4974364;171410
2021;8;Vorarlberg;4858143;297551;4560592;135399
2021;9;Wien;20081163;13195914;6885249;559674
2021;10;Österreich;87701064;20344707;67356357;2444280
2021;1;Burgenland;3058457;304722;2753735;85241
2021;2;Kärnten;4305917;387903;3918014;120008
2021;3;Niederösterreich;16400180;2348634;14051546;457083
2021;4;Oberösterreich;14517030;943505;13573525;404598
2021;5;Salzburg;6134666;632533;5502133;170977
2021;6;Steiermark;12399955;1073082;11326873;345594
2021;7;Tirol;6158145;1178662;4979483;171631
2021;8;Vorarlberg;4874252;297902;4576350;135848
2021;9;Wien;20261186;13353477;6907709;564691
2021;10;Österreich;88109788;20520420;67589368;2455672
2021;1;Burgenland;3062457;305232;2757225;85352
2021;2;Kärnten;4306716;388702;3918014;120031
2021;3;Niederösterreich;16449658;2353834;14095824;458462
2021;4;Oberösterreich;14586432;945790;13640642;406532
2021;5;Salzburg;6159640;635563;5524077;171673
2021;6;Steiermark;12450394;1087801;11362593;347000
2021;7;Tirol;6165018;1180770;4984248;171823
2021;8;Vorarlberg;4886927;298393;4588534;136202
2021;9;Wien;20329666;13409525;6920141;566600
2021;10;Österreich;88396908;20605610;67791298;2463674
2021;1;Burgenland;3067124;305817;2761307;85483
2021;2;Kärnten;4312759;389482;3923277;120199
2021;3;Niederösterreich;16490147;2359424;14130723;459590
2021;4;Oberösterreich;14640596;952973;13687623;408042
2021;5;Salzburg;6186865;637294;5549571;172432
2021;6;Steiermark;12483984;1089433;11394551;347936
2021;7;Tirol;6181874;1183014;4998860;172292
2021;8;Vorarlberg;4898655;298629;4600026;136528
2021;9;Wien;20500300;13576393;6923907;571355
2021;10;Österreich;88762304;20792459;67969845;2473858
2021;1;Burgenland;3071452;307643;2763809;85603
2021;2;Kärnten;4314091;390499;3923592;120236
2021;3;Niederösterreich;16522678;2364644;14158034;460497
2021;4;Oberösterreich;14688226;956778;13731448;409370
2021;5;Salzburg;6208504;641732;5566772;173035
2021;6;Steiermark;12561427;1107868;11453559;350094
2021;7;Tirol;6188382;1186427;5001955;172474
2021;8;Vorarlberg;4909504;299285;4610219;136831
2021;9;Wien;20624639;13697051;6927588;574821
2021;10;Österreich;89088903;20951927;68136976;2482960
2021;1;Burgenland;3075070;308226;2766844;85704
2021;2;Kärnten;4424830;392333;4032497;123323
2021;3;Niederösterreich;16556955;2370511;14186444;461452
2021;4;Oberösterreich;14743316;961059;13782257;410905
2021;5;Salzburg;6229571;646121;5583450;173622
2021;6;Steiermark;12595975;1115829;11480146;351057
2021;7;Tirol;6193940;1188887;5005053;172629
2021;8;Vorarlberg;4920736;299892;4620844;137144
2021;9;Wien;20781565;13850203;6931362;579194
2021;10;Österreich;89521958;21133061;68388897;2495030
2021;1;Burgenland;3080378;310098;2770280;85852
2021;2;Kärnten;4425733;393236;4032497;123348
2021;3;Niederösterreich;16590454;2376322;14214132;462386
2021;4;Oberösterreich;14788629;965175;13823454;412168
2021;5;Salzburg;6249599;649846;5599753;174180
2021;6;Steiermark;12631506;1124386;11507120;352048
2021;7;Tirol;6200195;1192108;5008087;172803
2021;8;Vorarlberg;4931691;300310;4631381;137449
2021;9;Wien;20893884;13958970;6934914;582325
2021;10;Österreich;89792069;21270451;68521618;2502558
2021;1;Burgenland;3087422;310416;2777006;86048
2021;2;Kärnten;4434697;398180;4036517;123598
2021;3;Niederösterreich;16631471;2382300;14249171;463529
2021;4;Oberösterreich;14843267;969638;13873629;413691
2021;5;Salzburg;6274946;654796;5620150;174886
2021;6;Steiermark;12673163;1131235;11541928;353209
2021;7;Tirol;6206877;1195071;5011806;172989
2021;8;Vorarlberg;4945650;300818;4644832;137838
2021;9;Wien;20982018;14043361;6938657;584781
2021;10;Österreich;90079511;21385815;68693696;2510569
2021;1;Burgenland;3092687;312149;2780538;86195
2021;2;Kärnten;4435247;398730;4036517;123613
2021;3;Niederösterreich;16686269;2388291;14297978;465056
2021;4;Oberösterreich;14907321;971044;13936277;415476
2021;5;Salzburg;6304475;659428;5645047;175709
2021;6;Steiermark;12719455;1140441;11579014;354499
2021;7;Tirol;6214094;1198087;5016007;173190
2021;8;Vorarlberg;4961531;301198;4660333;138281
2021;9;Wien;21056691;14114056;6942635;586862
2021;10;Österreich;90377770;21483424;68894346;2518882
2021;1;Burgenland;3095894;312480;2783414;86284
2021;2;Kärnten;4435926;399409;4036517;123632
2021;3;Niederösterreich;16737009;2394275;14342734;466470
2021;4;Oberösterreich;14963423;972818;13990605;417039
2021;5;Salzburg;6325294;662216;5663078;176290
2021;6;Steiermark;12750418;1147833;11602585;355362
2021;7;Tirol;6220665;1200273;5020392;173374
2021;8;Vorarlberg;4973586;301559;4672027;138617
2021;9;Wien;21111744;14164150;6947594;588397
2021;10;Österreich;90613959;21555013;69058946;2525464
2021;1;Burgenland;3101880;315150;2786730;86451
2021;2;Kärnten;4443051;400153;4042898;123830
2021;3;Niederösterreich;16775556;2400509;14375047;467545
2021;4;Oberösterreich;15013938;979586;14034352;418447
2021;5;Salzburg;6352253;664189;5688064;177041
2021;6;Steiermark;12787407;1155763;11631644;356393
2021;7;Tirol;6226056;1202498;5023558;173524
2021;8;Vorarlberg;4985079;301759;4683320;138937
2021;9;Wien;21280543;14329643;6950900;593101
2021;10;Österreich;90965763;21749250;69216513;2535269
2021;1;Burgenland;3105084;315621;2789463;86541
2021;2;Kärnten;4444567;401037;4043530;123873
2021;3;Niederösterreich;16814733;2407397;14407336;468637
2021;4;Oberösterreich;15059006;983432;14075574;419703
2021;5;Salzburg;6373460;668862;5704598;177632
2021;6;Steiermark;12860683;1164313;11696370;358435
2021;7;Tirol;6242087;1205419;5036668;173971
2021;8;Vorarlberg;4995756;302104;4693652;139235
2021;9;Wien;21399453;14446219;6953234;596415
2021;10;Österreich;91294829;21894404;69400425;2544441
2021;1;Burgenland;3109749;317772;2791977;86671
2021;2;Kärnten;4552479;401858;4150621;126880
2021;3;Niederösterreich;16842583;2413473;14429110;469413
2021;4;Oberösterreich;15112361;987521;14124840;421190
2021;5;Salzburg;6394376;673011;5721365;178215
2021;6;Steiermark;12895594;1173308;11722286;359408
2021;7;Tirol;6247293;1207433;5039860;174116
2021;8;Vorarlberg;5006902;302498;4704404;139545
2021;9;Wien;21560933;14604496;6956437;600916
2021;10;Österreich;91722270;22081370;69640900;2556354
2021;1;Burgenland;3112432;318128;2794304;86745
2021;2;Kärnten;4553305;402684;4150621;126903
2021;3;Niederösterreich;16884855;2420091;14464764;470591
2021;4;Oberösterreich;15158062;992176;14165886;422464
2021;5;Salzburg;6413350;676626;5736724;178744
2021;6;Steiermark;12928009;1179411;11748598;360311
2021;7;Tirol;6254393;1211347;5043046;174314
2021;8;Vorarlberg;5018164;302974;4715190;139859
2021;9;Wien;21680550;14721031;6959519;604250
2021;10;Österreich;92003120;22224468;69778652;2564181
2021;1;Burgenland;3121462;318393;2803069;86997
2021;2;Kärnten;4561812;407308;4154504;127140
2021;3;Niederösterreich;16928121;2427669;14500452;471797
2021;4;Oberösterreich;15211571;996302;14215269;423955
2021;5;Salzburg;6441038;682295;5758743;179516
2021;6;Steiermark;12964880;1182129;11782751;361339
2021;7;Tirol;6262076;1215111;5046965;174528
2021;8;Vorarlberg;5032127;303374;4728753;140248
2021;9;Wien;21801851;14839050;6962801;607630
2021;10;Österreich;92324938;22371631;69953307;2573150
2021;1;Burgenland;3124967;318732;2806235;87095
2021;2;Kärnten;4562340;407836;4154504;127155
2021;3;Niederösterreich;16974530;2434035;14540495;473090
2021;4;Oberösterreich;15273302;997852;14275450;425676
2021;5;Salzburg;6468821;687077;5781744;180290
2021;6;Steiermark;13020016;1197731;11822285;362876
2021;7;Tirol;6268556;1217161;5051395;174708
2021;8;Vorarlberg;5047274;303690;4743584;140671
2021;9;Wien;21883260;14917055;6966205;609899
2021;10;Österreich;92623066;22481169;70141897;2581459
2021;1;Burgenland;3128190;319003;2809187;87185
2021;2;Kärnten;4563048;408544;4154504;127175
2021;3;Niederösterreich;17018318;2440728;14577590;474311
2021;4;Oberösterreich;15328195;999508;14328687;427206
2021;5;Salzburg;6490492;690714;5799778;180894
2021;6;Steiermark;13055100;1205215;11849885;363853
2021;7;Tirol;6276096;1220268;5055828;174918
2021;8;Vorarlberg;5059071;303994;4755077;140999
2021;9;Wien;21952963;14982442;6970521;611842
2021;10;Österreich;92871473;22570416;70301057;2588383
2021;1;Burgenland;3133011;320091;2812920;87319
2021;2;Kärnten;4567382;409600;4157782;127296
2021;3;Niederösterreich;17063131;2452857;14610274;475560
2021;4;Oberösterreich;15375744;1007366;14368378;428531
2021;5;Salzburg;6518907;693113;5825794;181686
2021;6;Steiermark;13090903;1211429;11879474;364851
2021;7;Tirol;6276096;1220268;5055828;174918
2021;8;Vorarlberg;5070748;304395;4766353;141325
2021;9;Wien;22140441;15166558;6973883;617067
2021;10;Österreich;93236363;22785677;70450686;2598552
2021;1;Burgenland;3135860;320617;2815243;87398
2021;2;Kärnten;4572840;410672;4162168;127448
2021;3;Niederösterreich;17098479;2462443;14636036;476545
2021;4;Oberösterreich;15426356;1012410;14413946;429942
2021;5;Salzburg;6539131;697232;5841899;182249
2021;6;Steiermark;13165412;1223970;11941442;366928
2021;7;Tirol;6289007;1226688;5062319;175278
2021;8;Vorarlberg;5081435;304994;4776441;141623
2021;9;Wien;22263218;15287464;6975754;620489
2021;10;Österreich;93571738;22946490;70625248;2607900
2021;1;Burgenland;3139198;321299;2817899;87491
2021;2;Kärnten;4673453;411939;4261514;130252
2021;3;Niederösterreich;17145124;2470890;14674234;477845
2021;4;Oberösterreich;15481035;1017092;14463943;431466
2021;5;Salzburg;6566082;703973;5862109;183001
2021;6;Steiermark;13200327;1231530;11968797;367901
2021;7;Tirol;6307111;1230093;5077018;175783
2021;8;Vorarlberg;5093003;305537;4787466;141945
2021;9;Wien;22421570;15442930;6978640;624902
2021;10;Österreich;94026903;23135283;70891620;2620585
2021;1;Burgenland;3152871;332597;2820274;87872
2021;2;Kärnten;4674562;413048;4261514;130283
2021;3;Niederösterreich;17184198;2480352;14703846;478934
2021;4;Oberösterreich;15526885;1022722;14504163;432743
2021;5;Salzburg;6589814;710077;5879737;183662
2021;6;Steiermark;13239058;1241966;11997092;368980
2021;7;Tirol;6314603;1234041;5080562;175992
2021;8;Vorarlberg;5104144;306148;4797996;142256
2021;9;Wien;22525612;15544706;6980906;627802
2021;10;Österreich;94311747;23285657;71026090;2628524
2021;1;Burgenland;3161759;332972;2828787;88120
2021;2;Kärnten;4679385;417871;4261514;130417
2021;3;Niederösterreich;17229035;2489530;14739505;480183
2021;4;Oberösterreich;15582379;1028792;14553587;434290
2021;5;Salzburg;6618768;716966;5901802;184469
2021;6;Steiermark;13284978;1252329;12032649;370260
2021;7;Tirol;6324026;1238930;5085096;176254
2021;8;Vorarlberg;5118236;306740;4811496;142648
2021;9;Wien;22629170;15645703;6983467;630688
2021;10;Österreich;94627736;23429833;71197903;2637331
2021;1;Burgenland;3167118;335144;2831974;88269
2021;2;Kärnten;4682866;417925;4264941;130514
2021;3;Niederösterreich;17282347;2498412;14783935;481669
2021;4;Oberösterreich;15643295;1031448;14611847;435988
2021;5;Salzburg;6652040;724676;5927364;185396
2021;6;Steiermark;13335365;1263050;12072315;371664
2021;7;Tirol;6331933;1242250;5089683;176475
2021;8;Vorarlberg;5133157;307532;4825625;143064
2021;9;Wien;22713854;15727808;6986046;633049
2021;10;Österreich;94941975;23548245;71393730;2646089
2021;1;Burgenland;3170388;335458;2834930;88361
2021;2;Kärnten;4686314;421373;4264941;130610
2021;3;Niederösterreich;17333233;2509175;14824058;483087
2021;4;Oberösterreich;15699772;1033732;14666040;437562
2021;5;Salzburg;6675755;728903;5946852;186057
2021;6;Steiermark;13371714;1273289;12098425;372678
2021;7;Tirol;6340079;1245939;5094140;176702
2021;8;Vorarlberg;5145195;308239;4836956;143400
2021;9;Wien;22765321;15775947;6989374;634483
2021;10;Österreich;95187771;23632055;71555716;2652939
2021;1;Burgenland;3182781;342782;2839999;88706
2021;2;Kärnten;4689009;422684;4266325;130685
2021;3;Niederösterreich;17386062;2519226;14866836;484560
2021;4;Oberösterreich;15769713;1036533;14733180;439511
2021;5;Salzburg;6709469;732592;5976877;186997
2021;6;Steiermark;13425226;1275095;12150131;374169
2021;7;Tirol;6359670;1250338;5109332;177248
2021;8;Vorarlberg;5157889;308820;4849069;143753
2021;9;Wien;22861981;15869779;6992202;637177
2021;10;Österreich;95541800;23757849;71783951;2662806
2021;1;Burgenland;3186822;343089;2843733;88819
2021;2;Kärnten;4692552;423660;4268892;130784
2021;3;Niederösterreich;17439778;2529064;14910714;486057
2021;4;Oberösterreich;15820668;1039328;14781340;440931
2021;5;Salzburg;6737197;738655;5998542;187770
2021;6;Steiermark;13469105;1287064;12182041;375392
2021;7;Tirol;6367686;1253881;5113805;177471
2021;8;Vorarlberg;5170016;309811;4860205;144091
2021;9;Wien;22926575;15929417;6997158;638977
2021;10;Österreich;95810399;23853969;71956430;2670292
2021;1;Burgenland;3194230;346352;2847878;89025
2021;2;Kärnten;4785987;425554;4360433;133388
2021;3;Niederösterreich;17494065;2540851;14953214;487570
2021;4;Oberösterreich;15888392;1045793;14842599;442819
2021;5;Salzburg;6762893;743835;6019058;188486
2021;6;Steiermark;13540767;1304833;12235934;377389
2021;7;Tirol;6376035;1258474;5117561;177704
2021;8;Vorarlberg;5182588;310636;4871952;144442
2021;9;Wien;23037437;16035685;7001752;642067
2021;10;Österreich;96262394;24012013;72250381;2682890
2021;1;Burgenland;3198185;346664;2851521;89135
2021;2;Kärnten;4787752;426907;4360845;133437
2021;3;Niederösterreich;17540989;2553072;14987917;488878
2021;4;Oberösterreich;15945230;1052775;14892455;444403
2021;5;Salzburg;6791668;751499;6040169;189288
2021;6;Steiermark;13584678;1313829;12270849;378613
2021;7;Tirol;6383536;1262607;5120929;177913
2021;8;Vorarlberg;5195154;311828;4883326;144792
2021;9;Wien;23148129;16142482;7005647;645152
2021;10;Österreich;96575321;24161663;72413658;2691611
2021;1;Burgenland;3209588;349774;2859814;89453
2021;2;Kärnten;4789144;428299;4360845;133476
2021;3;Niederösterreich;17607188;2565287;15041901;490723
2021;4;Oberösterreich;16011294;1059179;14952115;446244
2021;5;Salzburg;6822135;758154;6063981;190137
2021;6;Steiermark;13636079;1325809;12310270;380046
2021;7;Tirol;6393555;1268348;5125207;178192
2021;8;Vorarlberg;5209129;312867;4896262;145181
2021;9;Wien;23235629;16226056;7009573;647591
2021;10;Österreich;96913741;24293773;72619968;2701043
2021;1;Burgenland;3212999;350132;2862867;89548
2021;2;Kärnten;4795173;434328;4360845;133644
2021;3;Niederösterreich;17665463;2577208;15088255;492347
2021;4;Oberösterreich;16076693;1062283;15014410;448067
2021;5;Salzburg;6855801;768004;6087797;191075
2021;6;Steiermark;13688518;1338194;12350324;381507
2021;7;Tirol;6401948;1272479;5129469;178426
2021;8;Vorarlberg;5223677;313931;4909746;145587
2021;9;Wien;23334330;16320650;7013680;650342
2021;10;Österreich;97254602;24437209;72817393;2710543
2021;1;Burgenland;3216513;350723;2865790;89646
2021;2;Kärnten;4801002;435459;4365543;133807
2021;3;Niederösterreich;17720008;2588299;15131709;493867
2021;4;Oberösterreich;16143528;1065782;15077746;449930
2021;5;Salzburg;6883440;774985;6108455;191846
2021;6;Steiermark;13731693;1353556;12378137;382710
2021;7;Tirol;6410093;1276618;5133475;178653
2021;8;Vorarlberg;5235619;314665;4920954;145920
2021;9;Wien;23389206;16370399;7018807;651871
2021;10;Österreich;97531102;24530486;73000616;2718249
2021;1;Burgenland;3220759;351917;2868842;89764
2021;2;Kärnten;4803126;436672;4366454;133866
2021;3;Niederösterreich;17777799;2600806;15176993;495478
2021;4;Oberösterreich;16217627;1068610;15149017;451995
2021;5;Salzburg;6907480;779401;6128079;192516
2021;6;Steiermark;13772660;1355774;12416886;383852
2021;7;Tirol;6422593;1282863;5139730;179001
2021;8;Vorarlberg;5248174;315549;4932625;146270
2021;9;Wien;23467266;16442652;7024614;654047
2021;10;Österreich;97837484;24634244;73203240;2726788
2021;1;Burgenland;3233425;359421;2874004;90117
2021;2;Kärnten;4811930;438851;4373079;134111
2021;3;Niederösterreich;17868237;2619361;15248876;497998
2021;4;Oberösterreich;16340102;1081129;15258973;455408
2021;5;Salzburg;6957249;787834;6169415;193903
2021;6;Steiermark;13867663;1379045;12488618;386500
2021;7;Tirol;6432860;1288114;5144746;179288
2021;8;Vorarlberg;5267387;316482;4950905;146805
2021;9;Wien;23639958;16609976;7029982;658860
2021;10;Österreich;98418811;24880213;73538598;2742990
2021;1;Burgenland;3238936;360333;2878603;90271
2021;2;Kärnten;4820807;440288;4380519;134359
2021;3;Niederösterreich;17938778;2634450;15304328;499964
2021;4;Oberösterreich;16450678;1091159;15359519;458490
2021;5;Salzburg;6999136;802600;6196536;195070
2021;6;Steiermark;13929762;1397582;12532180;388231
2021;7;Tirol;6443009;1293664;5149345;179570
2021;8;Vorarlberg;5284911;317585;4967326;147294
2021;9;Wien;23862973;16829567;7033406;665075
2021;10;Österreich;98968990;25167228;73801762;2758324
2021;1;Burgenland;3246963;365054;2881909;90495
2021;2;Kärnten;4823398;442879;4380519;134431
2021;3;Niederösterreich;18008516;2650198;15358318;501908
2021;4;Oberösterreich;16550120;1101956;15448164;461262
2021;5;Salzburg;7036044;814863;6221181;196099
2021;6;Steiermark;13991303;1419724;12571579;389946
2021;7;Tirol;6453312;1299593;5153719;179858
2021;8;Vorarlberg;5302034;319309;4982725;147771
2021;9;Wien;24030602;16993854;7036748;669747
2021;10;Österreich;99442292;25407430;74034862;2771515
2021;1;Burgenland;3257357;367922;2889435;90784
2021;2;Kärnten;4825373;444854;4380519;134486
2021;3;Niederösterreich;18082252;2669839;15412413;503963
2021;4;Oberösterreich;16637553;1108517;15529036;463698
2021;5;Salzburg;7071784;825784;6246000;197095
2021;6;Steiermark;14032909;1422603;12610306;391105
2021;7;Tirol;6463859;1305816;5158043;180152
2021;8;Vorarlberg;5318632;320782;4997850;148233
2021;9;Wien;24167488;17127335;7040153;673562
2021;10;Österreich;99857207;25593452;74263755;2783079
2021;1;Burgenland;3267806;375701;2892105;91076
2021;2;Kärnten;4836903;452103;4384800;134807
2021;3;Niederösterreich;18145213;2687062;15458151;505718
2021;4;Oberösterreich;16711252;1112905;15598347;465752
2021;5;Salzburg;7107785;839291;6268494;198098
2021;6;Steiermark;14102367;1436049;12666318;393041
2021;7;Tirol;6472657;1310041;5162616;180397
2021;8;Vorarlberg;5333608;321993;5011615;148651
2021;9;Wien;24276884;17233495;7043389;676611
2021;10;Österreich;100254475;25768640;74485835;2794151
2021;1;Burgenland;3273065;378369;2894696;91222
2021;2;Kärnten;4838795;453871;4384924;134860
2021;3;Niederösterreich;18205766;2705318;15500448;507405
2021;4;Oberösterreich;16817061;1151990;15665071;468701
2021;5;Salzburg;7135128;848425;6286703;198860
2021;6;Steiermark;14150772;1455631;12695141;394390
2021;7;Tirol;6487211;1318521;5168690;180802
2021;8;Vorarlberg;5345444;323092;5022352;148981
2021;9;Wien;24382203;17334510;7047693;679546
2021;10;Österreich;100635445;25969727;74665718;2804769
2021;1;Burgenland;3281836;384172;2897664;91467
2021;2;Kärnten;4846369;456841;4389528;135071
2021;3;Niederösterreich;18241844;2724662;15517182;508411
2021;4;Oberösterreich;16877030;1180946;15696084;470373
2021;5;Salzburg;7179867;861326;6318541;200107
2021;6;Steiermark;14186463;1473306;12713157;395385
2021;7;Tirol;6521327;1329134;5192193;181753
2021;8;Vorarlberg;5351085;324310;5026775;149138
2021;9;Wien;24604582;17553389;7051193;685744
2021;10;Österreich;101090403;26288086;74802317;2817449
2021;1;Burgenland;3285723;385034;2900689;91575
2021;2;Kärnten;4848749;459221;4389528;135137
2021;3;Niederösterreich;18280183;2744334;15535849;509479
2021;4;Oberösterreich;16947818;1224462;15723356;472346
2021;5;Salzburg;7215636;877052;6338584;201104
2021;6;Steiermark;14219760;1482362;12737398;396313
2021;7;Tirol;6533809;1337501;5196308;182101
2021;8;Vorarlberg;5356545;326205;5030340;149290
2021;9;Wien;24782476;17727655;7054821;690702
2021;10;Österreich;101470699;26563826;74906873;2828048
2021;1;Burgenland;3289400;386276;2903124;91678
2021;2;Kärnten;5101210;462133;4639077;142174
2021;3;Niederösterreich;18313876;2765332;15548544;510419
2021;4;Oberösterreich;16993952;1257726;15736226;473631
2021;5;Salzburg;7255994;895639;6360355;202229
2021;6;Steiermark;14278061;1502190;12775871;397938
2021;7;Tirol;6544996;1344943;5200053;182413
2021;8;Vorarlberg;5361944;327964;5033980;149441
2021;9;Wien;25023923;17966006;7057917;697431
2021;10;Österreich;102163356;26908209;75255147;2847353
2021;1;Burgenland;3295668;390711;2904957;91852
2021;2;Kärnten;5120178;481101;4639077;142702
2021;3;Niederösterreich;18345278;2786269;15559009;511294
2021;4;Oberösterreich;17036127;1287676;15748451;474807
2021;5;Salzburg;7297944;915702;6382242;203398
2021;6;Steiermark;14356213;1567104;12789109;400116
2021;7;Tirol;6557609;1353516;5204093;182764
2021;8;Vorarlberg;5367808;329755;5038053;149604
2021;9;Wien;25231747;18170660;7061087;703224
2021;10;Österreich;102608572;27282494;75326078;2859761
2021;1;Burgenland;3308189;399853;2908336;92201
2021;2;Kärnten;5136111;492332;4643779;143146
2021;3;Niederösterreich;18378067;2806836;15571231;512208
2021;4;Oberösterreich;17079123;1321367;15757756;476005
2021;5;Salzburg;7330739;932878;6397861;204312
2021;6;Steiermark;14392508;1590599;12801909;401128
2021;7;Tirol;6571248;1364342;5206906;183145
2021;8;Vorarlberg;5372734;331475;5041259;149741
2021;9;Wien;25421387;18357432;7063955;708509
2021;10;Österreich;102990106;27597114;75392992;2870395
2021;1;Burgenland;3315401;406308;2909093;92402
2021;2;Kärnten;5137019;493240;4643779;143172
2021;3;Niederösterreich;18406400;2827355;15579045;512997
2021;4;Oberösterreich;17117177;1355318;15761859;477066
2021;5;Salzburg;7369269;956005;6413264;205386
2021;6;Steiermark;14409834;1597545;12812289;401611
2021;7;Tirol;6583645;1374095;5209550;183490
2021;8;Vorarlberg;5376589;333556;5043033;149849
2021;9;Wien;25598185;18531669;7066516;713437
2021;10;Österreich;103313519;27875091;75438428;2879409
2021;1;Burgenland;3323210;413140;2910070;92620
2021;2;Kärnten;5139268;495374;4643894;143234
2021;3;Niederösterreich;18437704;2848902;15588802;513870
2021;4;Oberösterreich;17165517;1393475;15772042;478413
2021;5;Salzburg;7403150;975261;6427889;206330
2021;6;Steiermark;14502388;1689391;12812997;404190
2021;7;Tirol;6598291;1383133;5215158;183898
2021;8;Vorarlberg;5380312;335082;5045230;149952
2021;9;Wien;25763477;18693148;7070329;718043
2021;10;Österreich;103713317;28226906;75486411;2890551
2021;1;Burgenland;3331642;419065;2912577;92855
2021;2;Kärnten;5149249;498863;4650386;143513
2021;3;Niederösterreich;18474759;2867552;15607207;514902
2021;4;Oberösterreich;17232699;1440475;15792224;480285
2021;5;Salzburg;7444556;990547;6454009;207484
2021;6;Steiermark;14524122;1690196;12833926;404796
2021;7;Tirol;6632569;1398279;5234290;184854
2021;8;Vorarlberg;5386990;337176;5049814;150139
2021;9;Wien;26001271;18927322;7073949;724671
2021;10;Österreich;104177857;28569475;75608382;2903498
2021;1;Burgenland;3336612;422990;2913622;92993
2021;2;Kärnten;5153192;501203;4651989;143623
2021;3;Niederösterreich;18516341;2887389;15628952;516061
2021;4;Oberösterreich;17289821;1480618;15809203;481878
2021;5;Salzburg;7490251;1016177;6474074;208758
2021;6;Steiermark;14598880;1712700;12886180;406879
2021;7;Tirol;6648615;1409993;5238622;185301
2021;8;Vorarlberg;5393329;339460;5053869;150315
2021;9;Wien;26344250;19267755;7076495;734230
2021;10;Österreich;104771291;29038285;75733006;2920038
2021;1;Burgenland;3346659;431335;2915324;93273
2021;2;Kärnten;5183352;522209;4661143;144463
2021;3;Niederösterreich;18551139;2906796;15644343;517031
2021;4;Oberösterreich;17370333;1522930;15847403;484121
2021;5;Salzburg;7535988;1040037;6495951;210032
2021;6;Steiermark;14663759;1761561;12902198;408688
2021;7;Tirol;6664904;1421958;5242946;185755
2021;8;Vorarlberg;5400212;342367;5057845;150507
2021;9;Wien;26608839;19529197;7079642;741604
2021;10;Österreich;105325185;29478390;75846795;2935475
2021;1;Burgenland;3358872;442080;2916792;93614
2021;2;Kärnten;5200744;539601;4661143;144948
2021;3;Niederösterreich;18582884;2926673;15656211;517916
2021;4;Oberösterreich;17426088;1563508;15862580;485675
2021;5;Salzburg;7582923;1064633;6518290;211341
2021;6;Steiermark;14719491;1803428;12916063;410241
2021;7;Tirol;6682343;1435393;5246950;186241
2021;8;Vorarlberg;5406706;344816;5061890;150688
2021;9;Wien;26917403;19835122;7082281;750204
2021;10;Österreich;105877454;29955254;75922200;2950867
2021;1;Burgenland;3368444;446218;2922226;93881
2021;2;Kärnten;5210162;549019;4661143;145210
2021;3;Niederösterreich;18619564;2947667;15671897;518938
2021;4;Oberösterreich;17474702;1607894;15866808;487030
2021;5;Salzburg;7618557;1082697;6535860;212334
2021;6;Steiermark;14743558;1813596;12929962;410912
2021;7;Tirol;6696195;1446151;5250044;186627
2021;8;Vorarlberg;5412739;347284;5065455;150856
2021;9;Wien;27164080;20078918;7085162;757079
2021;10;Österreich;106308001;30319444;75988557;2962867
2021;1;Burgenland;3378869;454385;2924484;94171
2021;2;Kärnten;5224487;558178;4666309;145610
2021;3;Niederösterreich;18647984;2967694;15680290;519730
2021;4;Oberösterreich;17527606;1648892;15878714;488505
2021;5;Salzburg;7647080;1100186;6546894;213129
2021;6;Steiermark;14783583;1842824;12940759;412027
2021;7;Tirol;6709923;1457335;5252588;187010
2021;8;Vorarlberg;5417022;349920;5067102;150976
2021;9;Wien;27495650;20407536;7088114;766320
2021;10;Österreich;106832204;30786950;76045254;2977477
2021;1;Burgenland;3383075;456194;2926881;94288
2021;2;Kärnten;5230627;564318;4666309;145781
2021;3;Niederösterreich;18680927;2988827;15692100;520648
2021;4;Oberösterreich;17580859;1689383;15891476;489989
2021;5;Salzburg;7679104;1118070;6561034;214021
2021;6;Steiermark;14808691;1867509;12941182;412727
2021;7;Tirol;6729635;1471763;5257872;187559
2021;8;Vorarlberg;5421735;352085;5069650;151107
2021;9;Wien;27672498;20580639;7091859;771249
2021;10;Österreich;107187151;31088788;76098363;2987369
2021;1;Burgenland;3388215;456960;2931255;94432
2021;2;Kärnten;5237058;570749;4666309;145960
2021;3;Niederösterreich;18718043;3007858;15710185;521683
2021;4;Oberösterreich;17641473;1732044;15909429;491678
2021;5;Salzburg;7703816;1128881;6574935;214710
2021;6;Steiermark;14878418;1917836;12960582;414670
2021;7;Tirol;6748791;1486575;5262216;188093
2021;8;Vorarlberg;5429380;354664;5074716;151320
2021;9;Wien;27870912;20776006;7094906;776779
2021;10;Österreich;107616106;31431573;76184533;2999324
2021;1;Burgenland;3405359;470953;2934406;94909
2021;2;Kärnten;5251291;580980;4670311;146357
2021;3;Niederösterreich;18758223;3026764;15731459;522803
2021;4;Oberösterreich;17694875;1768981;15925894;493167
2021;5;Salzburg;7747076;1151996;6595080;215916
2021;6;Steiermark;14942558;1927051;13015507;416458
2021;7;Tirol;6762679;1496865;5265814;188480
2021;8;Vorarlberg;5436478;357443;5079035;151518
2021;9;Wien;27985635;20888374;7097261;779976
2021;10;Österreich;107984174;31669407;76314767;3009583
2021;1;Burgenland;3415047;479156;2935891;95179
2021;2;Kärnten;5303658;603564;4700094;147816
2021;3;Niederösterreich;18790372;3046166;15744206;523699
2021;4;Oberösterreich;17772313;1817833;15954480;495325
2021;5;Salzburg;7786780;1174265;6612515;217022
2021;6;Steiermark;14991127;1964096;13027031;417812
2021;7;Tirol;6793680;1509317;5284363;189344
2021;8;Vorarlberg;5443475;360674;5082801;151713
2021;9;Wien;28307376;21207710;7099666;788943
2021;10;Österreich;108603828;32162781;76441047;3026853
2021;1;Burgenland;3421046;481200;2939846;95347
2021;2;Kärnten;5312800;612706;4700094;148071
2021;3;Niederösterreich;18818024;3063636;15754388;524469
2021;4;Oberösterreich;17822279;1852215;15970064;496717
2021;5;Salzburg;7818403;1190842;6627561;217904
2021;6;Steiermark;15065009;2027953;13037056;419871
2021;7;Tirol;6810151;1522479;5287672;189803
2021;8;Vorarlberg;5449988;363588;5086400;151894
2021;9;Wien;28692304;21590396;7101908;799671
2021;10;Österreich;109210004;32705015;76504989;3043747
2021;1;Burgenland;3434321;489833;2944488;95717
2021;2;Kärnten;5332330;623414;4708916;148615
2021;3;Niederösterreich;18844195;3081735;15762460;525199
2021;4;Oberösterreich;17869565;1891731;15977834;498035
2021;5;Salzburg;7842248;1203800;6638448;218568
2021;6;Steiermark;15094549;2048753;13045796;420694
2021;7;Tirol;6821372;1531315;5290057;190116
2021;8;Vorarlberg;5455539;366210;5089329;152049
2021;9;Wien;28862813;21759045;7103768;804424
2021;10;Österreich;109556932;32995836;76561096;3053416
2021;1;Burgenland;3441444;496063;2945381;95915
2021;2;Kärnten;5337043;628127;4708916;148747
2021;3;Niederösterreich;18864964;3098061;15766903;525778
2021;4;Oberösterreich;17910417;1929475;15980942;499174
2021;5;Salzburg;7865022;1217968;6647054;219203
2021;6;Steiermark;15132973;2078556;13054417;421765
2021;7;Tirol;6830761;1539037;5291724;190377
2021;8;Vorarlberg;5460154;369423;5090731;152178
2021;9;Wien;28982367;21877141;7105226;807756
2021;10;Österreich;109825145;33233851;76591294;3060892
2021;1;Burgenland;3445188;498866;2946322;96019
2021;2;Kärnten;5343729;634439;4709290;148933
2021;3;Niederösterreich;18888889;3113540;15775349;526444
2021;4;Oberösterreich;17956136;1964119;15992017;500448
2021;5;Salzburg;7887885;1230696;6657189;219840
2021;6;Steiermark;15139705;2082015;13057690;421953
2021;7;Tirol;6850109;1554119;5295990;190917
2021;8;Vorarlberg;5465238;371900;5093338;152319
2021;9;Wien;29133800;22026010;7107790;811976
2021;10;Österreich;110110679;33475704;76634975;3068850
2021;1;Burgenland;3454981;504989;2949992;96292
2021;2;Kärnten;5362424;648153;4714271;149454
2021;3;Niederösterreich;18920746;3131035;15789711;527332
2021;4;Oberösterreich;18006009;2009647;15996362;501838
2021;5;Salzburg;7914357;1235982;6678375;220578
2021;6;Steiermark;15193989;2120115;13073874;423465
2021;7;Tirol;6864772;1565144;5299628;191325
2021;8;Vorarlberg;5471923;374263;5097660;152506
2021;9;Wien;29390581;22280610;7109971;819133
2021;10;Österreich;110579782;33869938;76709844;3081924
2021;1;Burgenland;3463282;510603;2952679;96524
2021;2;Kärnten;5366660;652007;4714653;149572
2021;3;Niederösterreich;18945508;3147346;15798162;528022
2021;4;Oberösterreich;18053117;2054355;15998762;503151
2021;5;Salzburg;7953685;1260226;6693459;221674
2021;6;Steiermark;15253609;2128176;13125433;425127
2021;7;Tirol;6891703;1574616;5317087;192076
2021;8;Vorarlberg;5478993;377636;5101357;152703
2021;9;Wien;29664779;22552759;7112020;826775
2021;10;Österreich;111071336;34257724;76813612;3095624
2021;1;Burgenland;3470103;515270;2954833;96714
2021;2;Kärnten;5379269;664616;4714653;149923
2021;3;Niederösterreich;18981307;3163703;15817604;529020
2021;4;Oberösterreich;18136522;2110530;16025992;505476
2021;5;Salzburg;7983500;1279387;6704113;222505
2021;6;Steiermark;15275721;2139876;13135845;425743
2021;7;Tirol;6901229;1580265;5320964;192341
2021;8;Vorarlberg;5485620;380408;5105212;152887
2021;9;Wien;29924374;22809895;7114479;834010
2021;10;Österreich;111537645;34643950;76893695;3108620
2021;1;Burgenland;3475446;517397;2958049;96863
2021;2;Kärnten;5407987;670539;4737448;150724
2021;3;Niederösterreich;19006895;3180186;15826709;529733
2021;4;Oberösterreich;18166584;2131485;16035099;506313
2021;5;Salzburg;8008703;1294090;6714613;223207
2021;6;Steiermark;15332383;2187747;13144636;427323
2021;7;Tirol;6914023;1590356;5323667;192698
2021;8;Vorarlberg;5491141;382704;5108437;153041
2021;9;Wien;30134804;23018122;7116682;839875
2021;10;Österreich;111937966;34972626;76965340;3119777
2021;1;Burgenland;3484093;522598;2961495;97104
2021;2;Kärnten;5423758;678757;4745001;151163
2021;3;Niederösterreich;19029824;3196741;15833083;530372
2021;4;Oberösterreich;18210940;2169740;16041200;507550
2021;5;Salzburg;8026467;1304462;6722005;223702
2021;6;Steiermark;15366648;2213674;13152974;428278
2021;7;Tirol;6924999;1599238;5325761;193004
2021;8;Vorarlberg;5494331;385371;5108960;153130
2021;9;Wien;30273352;23154767;7118585;843736
2021;10;Österreich;112234412;35225348;77009064;3128039
2021;1;Burgenland;3493316;531247;2962069;97361
2021;2;Kärnten;5427484;682483;4745001;151267
2021;3;Niederösterreich;19050292;3212356;15837936;530943
2021;4;Oberösterreich;18241618;2197496;16044122;508405
2021;5;Salzburg;8046090;1317227;6728863;224249
2021;6;Steiermark;15408974;2248200;13160774;429457
2021;7;Tirol;6932994;1605683;5327311;193227
2021;8;Vorarlberg;5496221;387261;5108960;153183
2021;9;Wien;30429845;23309639;7120206;848098
2021;10;Österreich;112526834;35491592;77035242;3136189
2021;1;Burgenland;3496383;533166;2963217;97446
2021;2;Kärnten;5431708;686329;4745379;151385
2021;3;Niederösterreich;19071802;3226852;15844950;531542
2021;4;Oberösterreich;18287239;2234128;16053111;509676
2021;5;Salzburg;8067048;1329467;6737581;224833
2021;6;Steiermark;15462992;2297690;13165302;430963
2021;7;Tirol;6947627;1616296;5331331;193634
2021;8;Vorarlberg;5573887;389092;5184795;155348
2021;9;Wien;30568695;23445900;7122795;851968
2021;10;Österreich;112907381;35758920;77148461;3146795
2021;1;Burgenland;3505327;539195;2966132;97696
2021;2;Kärnten;5446122;698286;4747836;151787
2021;3;Niederösterreich;19099087;3242605;15856482;532303
2021;4;Oberösterreich;18335911;2255735;16080176;511033
2021;5;Salzburg;8088241;1332620;6755621;225424
2021;6;Steiermark;15488613;2308981;13179632;431677
2021;7;Tirol;6971974;1623651;5348323;194313
2021;8;Vorarlberg;5510265;392005;5118260;153574
2021;9;Wien;30849755;23724542;7125213;859801
2021;10;Österreich;113295295;36117620;77177675;3157607
2021;1;Burgenland;3507813;540337;2967476;97765
2021;2;Kärnten;5454680;700286;4754394;152025
2021;3;Niederösterreich;19119951;3258134;15861817;532884
2021;4;Oberösterreich;18385749;2297530;16088219;512422
2021;5;Salzburg;8123981;1355990;6767991;226420
2021;6;Steiermark;15542106;2312776;13229330;433168
2021;7;Tirol;6980529;1630277;5350252;194551
2021;8;Vorarlberg;5515540;394802;5120738;153721
2021;9;Wien;31060627;23933403;7127224;865678
2021;10;Österreich;113690976;36423535;77267441;3168635
2021;1;Burgenland;3517032;548601;2968431;98022
2021;2;Kärnten;5463268;708874;4754394;152265
2021;3;Niederösterreich;19149378;3274145;15875233;533704
2021;4;Oberösterreich;18434162;2326477;16107685;513771
2021;5;Salzburg;8144834;1368419;6776415;227001
2021;6;Steiermark;15556547;2320195;13236352;433570
2021;7;Tirol;6991901;1638633;5353268;194868
2021;8;Vorarlberg;5518905;396394;5122511;153815
2021;9;Wien;31216830;24087225;7129605;870031
2021;10;Österreich;113992857;36668963;77323894;3177048
2021;1;Burgenland;3521444;551168;2970276;98145
2021;2;Kärnten;5470876;716482;4754394;152477
2021;3;Niederösterreich;19172302;3290415;15881887;534343
2021;4;Oberösterreich;18473358;2356944;16116414;514863
2021;5;Salzburg;8154218;1373736;6780482;227263
2021;6;Steiermark;15607688;2362884;13244804;434995
2021;7;Tirol;7000539;1644825;5355714;195109
2021;8;Vorarlberg;5523911;398459;5125452;153955
2021;9;Wien;31479550;24347506;7132044;877354
2021;10;Österreich;114403886;37042419;77361467;3188504
2021;1;Burgenland;3525190;552078;2973112;98249
2021;2;Kärnten;5474626;720232;4754394;152581
2021;3;Niederösterreich;19195174;3306704;15888470;534981
2021;4;Oberösterreich;18486972;2370395;16116577;515243
2021;5;Salzburg;8175559;1386360;6789199;227858
2021;6;Steiermark;15619194;2367295;13251899;435316
2021;7;Tirol;7007791;1650439;5357352;195311
2021;8;Vorarlberg;5528412;400738;5127674;154080
2021;9;Wien;31655122;24521166;7133956;882247
2021;10;Österreich;114668040;37275407;77392633;3195866
2021;1;Burgenland;3534059;560561;2973498;98496
2021;2;Kärnten;5479079;724685;4754394;152705
2021;3;Niederösterreich;19215046;3323206;15891840;535535
2021;4;Oberösterreich;18522469;2398331;16124138;516232
2021;5;Salzburg;8193678;1398476;6795202;228363
2021;6;Steiermark;15679838;2421043;13258795;437006
2021;7;Tirol;7014329;1655589;5358740;195493
2021;8;Vorarlberg;5530511;401714;5128797;154139
2021;9;Wien;31787491;24651904;7135587;885936
2021;10;Österreich;114956500;37535509;77420991;3203905
2021;1;Burgenland;3538498;563934;2974564;98620
2021;2;Kärnten;5483601;729207;4754394;152831
2021;3;Niederösterreich;19237506;3339435;15898071;536161
2021;4;Oberösterreich;18556465;2424444;16132021;517180
2021;5;Salzburg;8212971;1409172;6803799;228900
2021;6;Steiermark;15685536;2421999;13263537;437165
2021;7;Tirol;7025875;1663232;5362643;195815
2021;8;Vorarlberg;5534592;403633;5130959;154252
2021;9;Wien;31942979;24804805;7138174;890270
2021;10;Österreich;115218023;37759861;77458162;3211194
2021;1;Burgenland;3546228;568924;2977304;98835
2021;2;Kärnten;5494733;740339;4754394;153141
2021;3;Niederösterreich;19264128;3355982;15908146;536903
2021;4;Oberösterreich;18612718;2461984;16150734;518747
2021;5;Salzburg;8236133;1415501;6820632;229546
2021;6;Steiermark;15712109;2434728;13277381;437906
2021;7;Tirol;7036865;1671181;5365684;196122
2021;8;Vorarlberg;5540022;405323;5134699;154404
2021;9;Wien;32235764;25094665;7141099;898430
2021;10;Österreich;115678700;38148627;77530073;3224034
2021;1;Burgenland;3549180;570448;2978732;98918
2021;2;Kärnten;5499562;741823;4757739;153276
2021;3;Niederösterreich;19295194;3372697;15922497;537768
2021;4;Oberösterreich;18657088;2504722;16152366;519984
2021;5;Salzburg;8269970;1436417;6833553;230489
2021;6;Steiermark;15793357;2465651;13327706;440170
2021;7;Tirol;7061731;1681060;5380671;196815
2021;8;Vorarlberg;5544582;406927;5137655;154531
2021;9;Wien;32474569;25331465;7143104;905085
2021;10;Österreich;116145233;38511210;77634023;3237036
2021;1;Burgenland;3557479;576961;2980518;99149
2021;2;Kärnten;5511744;752736;4759008;153616
2021;3;Niederösterreich;19319517;3389903;15929614;538446
2021;4;Oberösterreich;18688082;2515484;16172598;520848
2021;5;Salzburg;8292267;1450105;6842162;231110
2021;6;Steiermark;15836335;2499438;13336897;441368
2021;7;Tirol;7073051;1689498;5383553;197130
2021;8;Vorarlberg;5548802;408432;5140370;154648
2021;9;Wien;32728657;25583415;7145242;912167
2021;10;Österreich;116555934;38865972;77689962;3248483
2021;1;Burgenland;3565582;583840;2981742;99375
2021;2;Kärnten;5521082;758529;4762553;153876
2021;3;Niederösterreich;19343526;3407150;15936376;539115
2021;4;Oberösterreich;18739681;2560483;16179198;522286
2021;5;Salzburg;8315724;1463988;6851736;231764
2021;6;Steiermark;15860882;2515478;13345404;442052
2021;7;Tirol;7082182;1695874;5386308;197385
2021;8;Vorarlberg;5552829;409644;5143185;154761
2021;9;Wien;33003270;25855808;7147462;919821
2021;10;Österreich;116984758;39250794;77733964;3260434
2021;1;Burgenland;3569926;585212;2984714;99496
2021;2;Kärnten;5527765;765212;4762553;154062
2021;3;Niederösterreich;19369156;3425596;15943560;539830
2021;4;Oberösterreich;18771228;2586151;16185077;523165
2021;5;Salzburg;8333927;1474200;6859727;232271
2021;6;Steiermark;15903268;2549310;13353958;443233
2021;7;Tirol;7090144;1701405;5388739;197606
2021;8;Vorarlberg;5556552;410884;5145668;154864
2021;9;Wien;33195661;26046068;7149593;925183
2021;10;Österreich;117317627;39544038;77773589;3269711
2021;1;Burgenland;3580261;594816;2985445;99784
2021;2;Kärnten;5532893;770340;4762553;154205
2021;3;Niederösterreich;19392246;3444320;15947926;540473
2021;4;Oberösterreich;18808534;2620242;16188292;524205
2021;5;Salzburg;8354335;1487358;6866977;232840
2021;6;Steiermark;15917369;2555989;13361380;443626
2021;7;Tirol;7098444;1707319;5391125;197838
2021;8;Vorarlberg;5559091;412123;5146968;154935
2021;9;Wien;33337308;26185778;7151530;929130
2021;10;Österreich;117580481;39778285;77802196;3277037
2021;1;Burgenland;3585991;599570;2986421;99944
2021;2;Kärnten;5538254;775701;4762553;154354
2021;3;Niederösterreich;19416290;3462858;15953432;541143
2021;4;Oberösterreich;18850737;2655134;16195603;525381
2021;5;Salzburg;8371934;1496985;6874949;233331
2021;6;Steiermark;15925780;2559667;13366113;443861
2021;7;Tirol;7110246;1715418;5394828;198167
2021;8;Vorarlberg;5562240;413242;5148998;155023
2021;9;Wien;33471137;26316880;7154257;932860
2021;10;Österreich;117832609;39995455;77837154;3284064
2021;1;Burgenland;3591071;602489;2988582;100085
2021;2;Kärnten;5554024;785803;4768221;154794
2021;3;Niederösterreich;19445576;3482388;15963188;541960
2021;4;Oberösterreich;18889043;2681244;16207799;526449
2021;5;Salzburg;8391625;1500157;6891468;233880
2021;6;Steiermark;15996538;2616963;13379575;445833
2021;7;Tirol;7122246;1724569;5397677;198501
2021;8;Vorarlberg;5567280;414764;5152516;155163
2021;9;Wien;33592180;26434753;7157427;936234
2021;10;Österreich;118149583;40243130;77906453;3292899
2021;1;Burgenland;3592439;603215;2989224;100123
2021;2;Kärnten;5555173;786952;4768221;154826
2021;3;Niederösterreich;19476984;3500803;15976181;542835
2021;4;Oberösterreich;18920769;2704764;16216005;527333
2021;5;Salzburg;8429623;1525203;6904420;234939
2021;6;Steiermark;16054647;2625593;13429054;447452
2021;7;Tirol;7158034;1744514;5413520;199499
2021;8;Vorarlberg;5571622;416222;5155400;155284
2021;9;Wien;33928750;26768948;7159802;945614
2021;10;Österreich;118688041;40676214;78011827;3307906
2021;1;Burgenland;3602815;611550;2991265;100413
2021;2;Kärnten;5572488;797097;4775391;155309
2021;3;Niederösterreich;19503642;3520825;15982817;543578
2021;4;Oberösterreich;18978581;2744734;16233847;528944
2021;5;Salzburg;8453267;1540031;6913236;235598
2021;6;Steiermark;16084115;2646587;13437528;448274
2021;7;Tirol;7172605;1756420;5416185;199905
2021;8;Vorarlberg;5575486;417433;5158053;155392
2021;9;Wien;34083244;26921024;7162220;949920
2021;10;Österreich;119026243;40955701;78070542;3317332
2021;1;Burgenland;3609263;616535;2992728;100592
2021;2;Kärnten;5578429;803038;4775391;155474
2021;3;Niederösterreich;19533040;3540855;15992185;544397
2021;4;Oberösterreich;19020723;2780129;16240594;530119
2021;5;Salzburg;8478261;1554714;6923547;236294
2021;6;Steiermark;16119741;2671656;13448085;449267
2021;7;Tirol;7191194;1772553;5418641;200423
2021;8;Vorarlberg;5579845;418724;5161121;155514
2021;9;Wien;34423770;27259186;7164584;959411
2021;10;Österreich;119534266;41417390;78116876;3331491
2021;1;Burgenland;3618320;620612;2997708;100845
2021;2;Kärnten;5585219;809828;4775391;155663
2021;3;Niederösterreich;19560282;3561088;15999194;545157
2021;4;Oberösterreich;19055219;2810984;16244235;531080
2021;5;Salzburg;8507915;1572279;6935636;237121
2021;6;Steiermark;16140249;2686035;13454214;449838
2021;7;Tirol;7201703;1781045;5420658;200716
2021;8;Vorarlberg;5582017;419346;5162671;155574
2021;9;Wien;34672854;27505964;7166890;966353
2021;10;Österreich;119923778;41767181;78156597;3342346
2021;1;Burgenland;3630911;632164;2998747;101196
2021;2;Kärnten;5592981;813620;4779361;155880
2021;3;Niederösterreich;19578723;3577137;16001586;545671
2021;4;Oberösterreich;19086057;2838536;16247521;531940
2021;5;Salzburg;8527942;1584918;6943024;237679
2021;6;Steiermark;16221822;2763290;13458532;452112
2021;7;Tirol;7215118;1792253;5422865;201090
2021;8;Vorarlberg;5584407;420184;5164223;155641
2021;9;Wien;34776326;27607188;7169138;969237
2021;10;Österreich;120214287;42029290;78184997;3350443
2021;1;Burgenland;3636947;637080;2999867;101364
2021;2;Kärnten;5594634;815273;4779361;155926
2021;3;Niederösterreich;19599528;3594279;16005249;546250
2021;4;Oberösterreich;19126334;2871485;16254849;533062
2021;5;Salzburg;8529102;1585923;6943179;237711
2021;6;Steiermark;16242302;2778207;13464095;452683
2021;7;Tirol;7229276;1802878;5426398;201484
2021;8;Vorarlberg;5587155;420846;5166309;155717
2021;9;Wien;34862341;27690339;7172002;971634
2021;10;Österreich;120407619;42196310;78211309;3355831
2021;1;Burgenland;3641157;638839;3002318;101481
2021;2;Kärnten;5609938;823682;4786256;156352
2021;3;Niederösterreich;21500748;5211614;16289134;599239
2021;4;Oberösterreich;19179068;2905276;16273792;534532
2021;5;Salzburg;8566728;1597079;6969649;238760
2021;6;Steiermark;16282634;2806871;13475763;453807
2021;7;Tirol;7247572;1818352;5429220;201994
2021;8;Vorarlberg;5591609;422218;5169391;155841
2021;9;Wien;34984446;27810217;7174229;975037
2021;10;Österreich;122603900;44034148;78569752;3417043
2021;1;Burgenland;3648689;644344;3004345;101691
2021;2;Kärnten;5620459;834030;4786429;156646
2021;3;Niederösterreich;21524035;5227547;16296488;599888
2021;4;Oberösterreich;19211027;2931860;16279167;535423
2021;5;Salzburg;8596373;1614135;6982238;239586
2021;6;Steiermark;16360370;2836821;13523549;455973
2021;7;Tirol;7262098;1830405;5431693;202399
2021;8;Vorarlberg;5598236;426294;5171942;156026
2021;9;Wien;35099844;27924063;7175781;978253
2021;10;Österreich;122921131;44269499;78651632;3425884
2021;1;Burgenland;3654807;649317;3005490;101862
2021;2;Kärnten;5625840;839411;4786429;156795
2021;3;Niederösterreich;21544941;5244231;16300710;600470
2021;4;Oberösterreich;19250945;2954604;16296341;536535
2021;5;Salzburg;8616553;1625645;6990908;240148
2021;6;Steiermark;16386040;2854567;13531473;456689
2021;7;Tirol;7290310;1844075;5446235;203185
2021;8;Vorarlberg;5604619;430224;5174395;156204
2021;9;Wien;35252793;28074025;7178768;982516
2021;10;Österreich;123226848;44516099;78710749;3434405
2021;1;Burgenland;3661658;655034;3006624;102053
2021;2;Kärnten;5635480;847265;4788215;157064
2021;3;Niederösterreich;21567571;5262168;16305403;601101
2021;4;Oberösterreich;19294131;2992174;16301957;537739
2021;5;Salzburg;8644644;1643773;7000871;240931
2021;6;Steiermark;16420787;2880018;13540769;457657
2021;7;Tirol;7313265;1864366;5448899;203825
2021;8;Vorarlberg;5612950;435733;5177217;156436
2021;9;Wien;35428723;28248063;7180660;987419
2021;10;Österreich;123579209;44828594;78750615;3444225
2022;1;Burgenland;3669515;659538;3009977;102272
2022;2;Kärnten;5642117;853902;4788215;157249
2022;3;Niederösterreich;21587829;5278661;16309168;601666
2022;4;Oberösterreich;19323197;3017435;16305762;538549
2022;5;Salzburg;8674173;1660603;7013570;241754
2022;6;Steiermark;16450921;2903984;13546937;458497
2022;7;Tirol;7325190;1873871;5451319;204157
2022;8;Vorarlberg;5617573;438264;5179309;156565
2022;9;Wien;35617362;28434387;7182975;992677
2022;10;Österreich;123907877;45120645;78787232;3453386
2022;1;Burgenland;3679860;669346;3010514;102560
2022;2;Kärnten;5649888;859308;4790580;157466
2022;3;Niederösterreich;21605533;5294875;16310658;602159
2022;4;Oberösterreich;19348104;3040474;16307630;539243
2022;5;Salzburg;8691706;1671520;7020186;242243
2022;6;Steiermark;16474803;2924699;13550104;459162
2022;7;Tirol;7340919;1887637;5453282;204596
2022;8;Vorarlberg;5622433;441663;5180770;156701
2022;9;Wien;35693180;28508505;7184675;994790
2022;10;Österreich;124106426;45298027;78808399;3458919
2022;1;Burgenland;3685453;672941;3012512;102716
2022;2;Kärnten;5651313;860733;4790580;157505
2022;3;Niederösterreich;21626521;5311220;16315301;602744
2022;4;Oberösterreich;19398527;3082571;16315956;540648
2022;5;Salzburg;8693629;1673200;7020429;242297
2022;6;Steiermark;16490529;2934243;13556286;459601
2022;7;Tirol;7355563;1898339;5457224;205004
2022;8;Vorarlberg;5629283;446217;5183066;156891
2022;9;Wien;35773733;28585650;7188083;997035
2022;10;Österreich;124304551;45465114;78839437;3464441
2022;1;Burgenland;3690211;675932;3014279;102848
2022;2;Kärnten;5655826;862897;4792929;157631
2022;3;Niederösterreich;21651517;5327610;16323907;603441
2022;4;Oberösterreich;19437927;3113512;16324415;541746
2022;5;Salzburg;8720005;1683811;7036194;243032
2022;6;Steiermark;16557442;2956389;13601053;461466
2022;7;Tirol;7384294;1918143;5466151;205805
2022;8;Vorarlberg;5637147;450426;5186721;157111
2022;9;Wien;35901914;28711483;7190431;1000608
2022;10;Österreich;124636283;45700203;78936080;3473687
2022;1;Burgenland;3699077;681936;3017141;103095
2022;2;Kärnten;5668641;865893;4802748;157988
2022;3;Niederösterreich;21681582;5345100;16336482;604278
2022;4;Oberösterreich;19468989;3136897;16332092;542612
2022;5;Salzburg;8756522;1705803;7050719;244049
2022;6;Steiermark;16629275;2994994;13634281;463468
2022;7;Tirol;7402715;1934069;5468646;206318
2022;8;Vorarlberg;5834166;644425;5189741;162602
2022;9;Wien;36065902;28873800;7192102;1005178
2022;10;Österreich;125206869;46182917;79023952;3489589
2022;1;Burgenland;3707296;688981;3018315;103325
2022;2;Kärnten;5680753;878005;4802748;158326
2022;3;Niederösterreich;21709076;5361848;16347228;605045
2022;4;Oberösterreich;19501691;3161244;16340447;543524
2022;5;Salzburg;8783507;1722972;7060535;244802
2022;6;Steiermark;16656583;3012640;13643943;464229
2022;7;Tirol;7425749;1954601;5471148;206960
2022;8;Vorarlberg;5840284;648127;5192157;162772
2022;9;Wien;36221450;29027245;7194205;1009513
2022;10;Österreich;125526389;46455663;79070726;3498495
2022;1;Burgenland;3710837;690744;3020093;103423
2022;2;Kärnten;5693993;884736;4809257;158695
2022;3;Niederösterreich;21729964;5378508;16351456;605627
2022;4;Oberösterreich;19542148;3197283;16344865;544651
2022;5;Salzburg;8808812;1738476;7070336;245507
2022;6;Steiermark;16681736;3032397;13649339;464930
2022;7;Tirol;7442812;1968698;5474114;207436
2022;8;Vorarlberg;5846299;652412;5193887;162940
2022;9;Wien;36400937;29203783;7197154;1014516
2022;10;Österreich;125857538;46747037;79110501;3507724
2022;1;Burgenland;3734483;702109;3032374;104082
2022;2;Kärnten;5697921;886324;4811597;158804
2022;3;Niederösterreich;21755896;5396495;16359401;606350
2022;4;Oberösterreich;19573465;3222904;16350561;545524
2022;5;Salzburg;8823087;1747975;7075112;245905
2022;6;Steiermark;16718166;3057610;13660556;465945
2022;7;Tirol;7469550;1992465;5477085;208181
2022;8;Vorarlberg;5984837;787735;5197102;166801
2022;9;Wien;36571842;29372362;7199480;1019279
2022;10;Österreich;126329247;47165979;79163268;3520871
2022;1;Burgenland;3737938;703975;3033963;104179
2022;2;Kärnten;5708730;897133;4811597;159106
2022;3;Niederösterreich;21779566;5415164;16364402;607009
2022;4;Oberösterreich;19619835;3265181;16354654;546816
2022;5;Salzburg;8860678;1772360;7088318;246952
2022;6;Steiermark;16767489;3081512;13685977;467320
2022;7;Tirol;7502589;2022742;5479847;209102
2022;8;Vorarlberg;5996488;797515;5198973;167126
2022;9;Wien;36802633;29600499;7202134;1025711
2022;10;Österreich;126775946;47556081;79219865;3533320
2022;1;Burgenland;3752540;715560;3036980;104586
2022;2;Kärnten;5717150;905447;4811703;159340
2022;3;Niederösterreich;21806638;5434002;16372636;607764
2022;4;Oberösterreich;19673676;3308758;16364918;548317
2022;5;Salzburg;8888007;1789060;7098947;247714
2022;6;Steiermark;16808676;3115701;13692975;468468
2022;7;Tirol;7519893;2035010;5484883;209584
2022;8;Vorarlberg;6009167;807619;5201548;167479
2022;9;Wien;37128571;29922398;7206173;1034795
2022;10;Österreich;127304318;48033555;79270763;3548046
2022;1;Burgenland;3771307;728257;3043050;105109
2022;2;Kärnten;5732737;913712;4819025;159775
2022;3;Niederösterreich;21839448;5453014;16386434;608678
2022;4;Oberösterreich;19727822;3350761;16377061;549826
2022;5;Salzburg;8912083;1796086;7115997;248385
2022;6;Steiermark;16852209;3141908;13710301;469681
2022;7;Tirol;7547639;2059758;5487881;210357
2022;8;Vorarlberg;6019178;813617;5205561;167758
2022;9;Wien;37417656;30208246;7209410;1042852
2022;10;Österreich;127820079;48465359;79354720;3562421
2022;1;Burgenland;3785291;737257;3048034;105498
2022;2;Kärnten;5740202;921177;4819025;159983
2022;3;Niederösterreich;22664198;5773667;16890531;631665
2022;4;Oberösterreich;19782133;3402027;16380106;551340
2022;5;Salzburg;8953604;1825106;7128498;249542
2022;6;Steiermark;16885375;3149248;13736127;470605
2022;7;Tirol;7576891;2080122;5496769;211172
2022;8;Vorarlberg;6032460;823327;5209133;168128
2022;9;Wien;37869913;30658012;7211901;1055457
2022;10;Österreich;129290067;49369943;79920124;3603390
2022;1;Burgenland;3801591;748225;3053366;105953
2022;2;Kärnten;5752431;931700;4820731;160324
2022;3;Niederösterreich;22696468;5798504;16897964;632564
2022;4;Oberösterreich;19835340;3441811;16393529;552823
2022;5;Salzburg;8994487;1850959;7143528;250682
2022;6;Steiermark;16921101;3160815;13760286;471601
2022;7;Tirol;7601199;2101562;5499637;211850
2022;8;Vorarlberg;6043559;831081;5212478;168438
2022;9;Wien;38126082;30911834;7214248;1062596
2022;10;Österreich;129772258;49776491;79995767;3616829
2022;1;Burgenland;3813904;755233;3058671;106296
2022;2;Kärnten;5772703;945927;4826776;160889
2022;3;Niederösterreich;22732429;5823798;16908631;633566
2022;4;Oberösterreich;19921717;3490063;16431654;555230
2022;5;Salzburg;9026932;1871968;7154964;251586
2022;6;Steiermark;17006521;3219390;13787131;473982
2022;7;Tirol;7625039;2122687;5502352;212514
2022;8;Vorarlberg;6056424;840418;5216006;168796
2022;9;Wien;38553038;31336421;7216617;1074496
2022;10;Österreich;130508707;50405905;80102802;3637355
2022;1;Burgenland;3839700;763514;3076186;107015
2022;2;Kärnten;5781469;952564;4828905;161133
2022;3;Niederösterreich;22766806;5850458;16916348;634524
2022;4;Oberösterreich;19965939;3527489;16438450;556462
2022;5;Salzburg;9056067;1891471;7164596;252398
2022;6;Steiermark;17050957;3252668;13798289;475220
2022;7;Tirol;7649417;2144947;5504470;213194
2022;8;Vorarlberg;6067170;848140;5219030;169096
2022;9;Wien;38831297;31612323;7218974;1082251
2022;10;Österreich;131008822;50843574;80165248;3651293
2022;1;Burgenland;3853572;775407;3078165;107401
2022;2;Kärnten;5787106;958201;4828905;161290
2022;3;Niederösterreich;23103129;5878236;17224893;643898
2022;4;Oberösterreich;20011683;3568934;16442749;557737
2022;5;Salzburg;9086207;1911522;7174685;253238
2022;6;Steiermark;17090825;3283357;13807468;476331
2022;7;Tirol;7677974;2171389;5506585;213990
2022;8;Vorarlberg;6075618;855049;5220569;169331
2022;9;Wien;39051052;31829702;7221350;1088376
2022;10;Österreich;131737166;51231797;80505369;3671593
2022;1;Burgenland;3866337;784542;3081795;107757
2022;2;Kärnten;5798816;969911;4828905;161616
2022;3;Niederösterreich;23140954;5909995;17230959;644952
2022;4;Oberösterreich;20069844;3617567;16452277;559358
2022;5;Salzburg;9114633;1930664;7183969;254030
2022;6;Steiermark;17111393;3296954;13814439;476905
2022;7;Tirol;7700571;2189991;5510580;214619
2022;8;Vorarlberg;6087296;864398;5222898;169657
2022;9;Wien;39300330;32052976;7247354;1095323
2022;10;Österreich;132190174;51616998;80573176;3684218
2022;1;Burgenland;3879249;790071;3089178;108117
2022;2;Kärnten;5809091;973624;4835467;161903
2022;3;Niederösterreich;23194896;5950377;17244519;646455
2022;4;Oberösterreich;20117729;3655013;16462716;560693
2022;5;Salzburg;9144134;1938809;7205325;254852
2022;6;Steiermark;17169990;3338438;13831552;478538
2022;7;Tirol;7728534;2214943;5513591;215399
2022;8;Vorarlberg;6098085;871020;5227065;169957
2022;9;Wien;39580897;32329919;7250978;1103143
2022;10;Österreich;132722605;52062214;80660391;3699057
2022;1;Burgenland;3901949;806943;3095006;108750
2022;2;Kärnten;5825172;989378;4835794;162351
2022;3;Niederösterreich;23304302;5976901;17327401;649505
2022;4;Oberösterreich;20215294;3716560;16498734;563412
2022;5;Salzburg;9189783;1970219;7219564;256125
2022;6;Steiermark;17249708;3378676;13871032;480760
2022;7;Tirol;7770580;2241474;5529106;216571
2022;8;Vorarlberg;6113883;883304;5230579;170398
2022;9;Wien;39994294;32741008;7253286;1114665
2022;10;Österreich;133564965;52704463;80860502;3722534
2022;1;Burgenland;3915673;814104;3101569;109132
2022;2;Kärnten;5833224;995222;4838002;162575
2022;3;Niederösterreich;24206613;6187486;18019127;674653
2022;4;Oberösterreich;20257603;3750115;16507488;564591
2022;5;Salzburg;9222345;1990177;7232168;257032
2022;6;Steiermark;17293094;3409627;13883467;481969
2022;7;Tirol;7801635;2269373;5532262;217436
2022;8;Vorarlberg;6126656;892881;5233775;170754
2022;9;Wien;40296399;33040577;7255822;1123084
2022;10;Österreich;134953242;53349562;81603680;3761226
2022;1;Burgenland;3933136;825417;3107719;109619
2022;2;Kärnten;5851414;1006614;4844800;163082
2022;3;Niederösterreich;24234254;6206356;18027898;675423
2022;4;Oberösterreich;20320218;3804725;16515493;566336
2022;5;Salzburg;9237586;2005418;7232168;257457
2022;6;Steiermark;17336479;3440578;13895901;483178
2022;7;Tirol;7830643;2295820;5534823;218245
2022;8;Vorarlberg;6139293;902207;5237086;171106
2022;9;Wien;40686999;33428837;7258162;1133971
2022;10;Österreich;135570022;53915972;81654050;3778416
2022;1;Burgenland;3953631;836804;3116827;110190
2022;2;Kärnten;5865692;1019415;4846277;163480
2022;3;Niederösterreich;24283465;6249785;18033680;676794
2022;4;Oberösterreich;20364434;3838538;16525896;567569
2022;5;Salzburg;9284786;2031782;7253004;258772
2022;6;Steiermark;17389046;3481228;13907818;484643
2022;7;Tirol;7857192;2320310;5536882;218985
2022;8;Vorarlberg;6151486;910838;5240648;171446
2022;9;Wien;40959563;33697593;7261970;1141567
2022;10;Österreich;136109295;54386293;81723002;3793446
2022;1;Burgenland;3973293;853863;3119430;110738
2022;2;Kärnten;5876156;1029879;4846277;163772
2022;3;Niederösterreich;24329848;6287495;18042353;678087
2022;4;Oberösterreich;20419279;3886300;16532979;569097
2022;5;Salzburg;9312398;2050094;7262304;259542
2022;6;Steiermark;17422502;3504722;13917780;485575
2022;7;Tirol;7882570;2343796;5538774;219692
2022;8;Vorarlberg;6161511;918777;5242734;171725
2022;9;Wien;41196885;33930853;7266032;1148181
2022;10;Österreich;136574442;54805779;81768663;3806410
2022;1;Burgenland;3983283;861796;3121487;111016
2022;2;Kärnten;5882237;1035569;4846668;163941
2022;3;Niederösterreich;24364587;6316649;18047938;679055
2022;4;Oberösterreich;20477796;3929701;16548095;570728
2022;5;Salzburg;9338987;2067892;7271095;260283
2022;6;Steiermark;17470879;3529600;13941279;486924
2022;7;Tirol;7906103;2363899;5542204;220348
2022;8;Vorarlberg;6174173;928194;5245979;172078
2022;9;Wien;41434018;34163121;7270897;1154791
2022;10;Österreich;137032063;55196421;81835642;3819164
2022;1;Burgenland;4013890;873626;3140264;111869
2022;2;Kärnten;5886548;1039880;4846668;164062
2022;3;Niederösterreich;24423844;6362060;18061784;680707
2022;4;Oberösterreich;20530761;3962395;16568366;572204
2022;5;Salzburg;9360154;2080260;7279894;260873
2022;6;Steiermark;17523615;3563788;13959827;488393
2022;7;Tirol;7939337;2393922;5545415;221274
2022;8;Vorarlberg;6187749;935571;5252178;172456
2022;9;Wien;41700161;34424030;7276131;1162208
2022;10;Österreich;137566059;55635532;81930527;3834047
2022;1;Burgenland;4026498;879500;3146998;112221
2022;2;Kärnten;5910181;1056692;4853489;164720
2022;3;Niederösterreich;24481072;6398866;18082206;682302
2022;4;Oberösterreich;20613144;4023931;16589213;574500
2022;5;Salzburg;9395059;2103161;7291898;261846
2022;6;Steiermark;17611177;3608720;14002457;490834
2022;7;Tirol;7983994;2422099;5561895;222519
2022;8;Vorarlberg;6204052;946829;5257223;172911
2022;9;Wien;42132019;34852129;7279890;1174244
2022;10;Österreich;138357196;56291927;82065269;3856097
2022;1;Burgenland;4040301;887310;3152991;112606
2022;2;Kärnten;5929153;1066375;4862778;165249
2022;3;Niederösterreich;25668339;6766870;18901469;715392
2022;4;Oberösterreich;20665449;4068584;16596865;575958
2022;5;Salzburg;9422065;2126649;7295416;262599
2022;6;Steiermark;17660664;3643791;14016873;492213
2022;7;Tirol;8017152;2452459;5564693;223443
2022;8;Vorarlberg;6219149;957131;5262018;173331
2022;9;Wien;42470467;35186723;7283744;1183677
2022;10;Österreich;140092739;57155892;82936847;3904467
2022;1;Burgenland;4063824;904351;3159473;113261
2022;2;Kärnten;5937600;1074822;4862778;165484
2022;3;Niederösterreich;25706282;6794750;18911532;716449
2022;4;Oberösterreich;20763739;4116009;16647730;578698
2022;5;Salzburg;9444151;2145192;7298959;263214
2022;6;Steiermark;17719999;3690264;14029735;493867
2022;7;Tirol;8045869;2478590;5567279;224243
2022;8;Vorarlberg;6235267;968465;5266802;173781
2022;9;Wien;42877627;35590238;7287389;1195025
2022;10;Österreich;140794358;57762681;83031677;3924022
2022;1;Burgenland;4099137;917611;3181526;114245
2022;2;Kärnten;5945038;1080513;4864525;165692
2022;3;Niederösterreich;25769712;6847709;18922003;718217
2022;4;Oberösterreich;20823577;4161590;16661987;580365
2022;5;Salzburg;9466974;2164531;7302443;263850
2022;6;Steiermark;17762242;3719634;14042608;495044
2022;7;Tirol;8073768;2504618;5569150;225021
2022;8;Vorarlberg;6250047;978944;5271103;174192
2022;9;Wien;43171997;35881312;7290685;1203229
2022;10;Österreich;141362492;58256462;83106030;3939856
2022;1;Burgenland;4114617;931024;3183593;114677
2022;2;Kärnten;5953336;1088811;4864525;165923
2022;3;Niederösterreich;25803569;6876657;18926912;719161
2022;4;Oberösterreich;20872541;4202140;16670401;581730
2022;5;Salzburg;9487988;2183134;7304854;264436
2022;6;Steiermark;17800593;3747346;14053247;496113
2022;7;Tirol;8095693;2524511;5571182;225632
2022;8;Vorarlberg;6261669;988228;5273441;174516
2022;9;Wien;43398272;36104458;7293814;1209535
2022;10;Österreich;141788278;58646309;83141969;3951723
2022;1;Burgenland;4125173;937934;3187239;114971
2022;2;Kärnten;5964973;1100448;4864525;166247
2022;3;Niederösterreich;25850361;6917658;18932703;720465
2022;4;Oberösterreich;20936302;4250381;16685921;583507
2022;5;Salzburg;9504203;2198282;7305921;264888
2022;6;Steiermark;17839135;3777832;14061303;497187
2022;7;Tirol;8118062;2543442;5574620;226255
2022;8;Vorarlberg;6274734;997994;5276740;174881
2022;9;Wien;43467398;36169460;7297938;1211462
2022;10;Österreich;142080341;58893431;83186910;3959863
2022;1;Burgenland;4143063;948117;3194946;115470
2022;2;Kärnten;5974145;1105590;4868555;166503
2022;3;Niederösterreich;25908016;6961340;18946676;722072
2022;4;Oberösterreich;20984306;4286677;16697629;584845
2022;5;Salzburg;9532998;2212951;7320047;265690
2022;6;Steiermark;17881334;3801505;14079829;498363
2022;7;Tirol;8154216;2576723;5577493;227263
2022;8;Vorarlberg;6289018;1006067;5282951;175279
2022;9;Wien;43922057;36619684;7302373;1224134
2022;10;Österreich;142789153;59518654;83270499;3979618
2022;1;Burgenland;4159355;957197;3202158;115924
2022;2;Kärnten;5988089;1112798;4875291;166892
2022;3;Niederösterreich;26389128;7243472;19145656;735481
2022;4;Oberösterreich;21062606;4344341;16718265;587027
2022;5;Salzburg;9558737;2234951;7323786;266408
2022;6;Steiermark;18006163;3825189;14180974;501842
2022;7;Tirol;8188230;2597589;5590641;228211
2022;8;Vorarlberg;6308390;1019827;5288563;175819
2022;9;Wien;44352378;37047703;7304675;1236127
2022;10;Österreich;144013076;60383067;83630009;4013729
2022;1;Burgenland;4182101;973004;3209097;116558
2022;2;Kärnten;6004429;1127244;4877185;167347
2022;3;Niederösterreich;26951833;7279893;19671940;751163
2022;4;Oberösterreich;21152784;4376622;16776162;589541
2022;5;Salzburg;9579558;2252067;7327491;266988
2022;6;Steiermark;18100807;3906069;14194738;504480
2022;7;Tirol;8209465;2616372;5593093;228803
2022;8;Vorarlberg;6324473;1030714;5293759;176267
2022;9;Wien;44668822;37360246;7308576;1244946
2022;10;Österreich;145174272;60922231;84252041;4046093
2022;1;Burgenland;4203064;987609;3215455;117142
2022;2;Kärnten;6015106;1137921;4877185;167645
2022;3;Niederösterreich;27021095;7339595;19681500;753094
2022;4;Oberösterreich;21216625;4423158;16793467;591320
2022;5;Salzburg;9602058;2270935;7331123;267615
2022;6;Steiermark;18144430;3937941;14206489;505696
2022;7;Tirol;8254049;2658625;5595424;230045
2022;8;Vorarlberg;6340925;1042138;5298787;176725
2022;9;Wien;44973659;37661474;7312185;1253442
2022;10;Österreich;145771011;61459396;84311615;4062724
2022;1;Burgenland;4226485;996739;3229746;117795
2022;2;Kärnten;6026479;1141907;4884572;167962
2022;3;Niederösterreich;27083740;7392037;19691703;754840
2022;4;Oberösterreich;21271164;4463187;16807977;592840
2022;5;Salzburg;9622065;2287431;7334634;268173
2022;6;Steiermark;18181604;3962810;14218794;506732
2022;7;Tirol;8282027;2684882;5597145;230825
2022;8;Vorarlberg;6356482;1053132;5303350;177159
2022;9;Wien;45266877;37951022;7315855;1261615
2022;10;Österreich;146316923;61933147;84383776;4077939
2022;1;Burgenland;4249354;1012062;3237292;118432
2022;2;Kärnten;6031510;1146938;4884572;168102
2022;3;Niederösterreich;27120223;7424387;19695836;755857
2022;4;Oberösterreich;21320052;4504238;16815814;594202
2022;5;Salzburg;9640905;2303929;7336976;268698
2022;6;Steiermark;18247532;4018550;14228982;508569
2022;7;Tirol;8308570;2709678;5598892;231565
2022;8;Vorarlberg;6368730;1063074;5305656;177500
2022;9;Wien;45522433;38203317;7319116;1268737
2022;10;Österreich;146809309;62386173;84423136;4091662
2022;1;Burgenland;4263560;1022968;3240592;118828
2022;2;Kärnten;6039963;1155122;4884841;168337
2022;3;Niederösterreich;27284108;7583636;19700472;760424
2022;4;Oberösterreich;21376778;4545819;16830959;595783
2022;5;Salzburg;9656365;2318291;7338074;269129
2022;6;Steiermark;18288792;4052529;14236263;509719
2022;7;Tirol;8328886;2726883;5602003;232131
2022;8;Vorarlberg;6381253;1072615;5308638;177849
2022;9;Wien;45606732;38283527;7323205;1271087
2022;10;Österreich;147226437;62761390;84465047;4103288
2022;1;Burgenland;4281132;1032426;3248706;119318
2022;2;Kärnten;6053524;1159557;4893967;168715
2022;3;Niederösterreich;27395519;7645958;19749561;763529
2022;4;Oberösterreich;21440587;4586665;16853922;597562
2022;5;Salzburg;9679861;2329437;7350424;269783
2022;6;Steiermark;18339150;4085909;14253241;511123
2022;7;Tirol;8361580;2757242;5604338;233042
2022;8;Vorarlberg;6396114;1081222;5314892;178263
2022;9;Wien;45904905;38577669;7327236;1279397
2022;10;Österreich;147852372;63256085;84596287;4120733
2022;1;Burgenland;4296308;1041286;3255022;119741
2022;2;Kärnten;6069048;1171098;4897950;169148
2022;3;Niederösterreich;27636658;7697188;19939470;770250
2022;4;Oberösterreich;21534732;4630592;16904140;600186
2022;5;Salzburg;9705982;2351928;7354054;270511
2022;6;Steiermark;18421111;4122434;14298677;513407
2022;7;Tirol;8396341;2781178;5615163;234011
2022;8;Vorarlberg;6412604;1092815;5319789;178723
2022;9;Wien;46137789;38807577;7330212;1285887
2022;10;Österreich;148610573;63696096;84914477;4141864
2022;1;Burgenland;4314837;1053639;3261198;120257
2022;2;Kärnten;6081167;1183217;4897950;169486
2022;3;Niederösterreich;27992914;7747239;20245675;780179
2022;4;Oberösterreich;21584338;4664045;16920293;601568
2022;5;Salzburg;9726344;2369093;7357251;271079
2022;6;Steiermark;18473481;4162110;14311371;514867
2022;7;Tirol;8423259;2805955;5617304;234761
2022;8;Vorarlberg;6428631;1104117;5324514;179170
2022;9;Wien;46414303;39081007;7333296;1293594
2022;10;Österreich;149439274;64170422;85268852;4164961
2022;1;Burgenland;4332440;1065278;3267162;120748
2022;2;Kärnten;6088079;1187566;4900513;169678
2022;3;Niederösterreich;28028714;7773667;20255047;781177
2022;4;Oberösterreich;21641085;4705800;16935285;603150
2022;5;Salzburg;9746241;2385906;7360335;271633
2022;6;Steiermark;18523089;4201071;14322018;516249
2022;7;Tirol;8447457;2828257;5619200;235436
2022;8;Vorarlberg;6443443;1114174;5329269;179583
2022;9;Wien;46618103;39281905;7336198;1299274
2022;10;Österreich;149868651;64543624;85325027;4176928
2022;1;Burgenland;4360787;1075890;3284897;121538
2022;2;Kärnten;6105871;1199898;4905973;170174
2022;3;Niederösterreich;28334496;7978361;20356135;789699
2022;4;Oberösterreich;21682930;4734581;16948349;604316
2022;5;Salzburg;9762908;2399482;7363426;272098
2022;6;Steiermark;18568099;4234401;14333698;517504
2022;7;Tirol;8471990;2851239;5620751;236119
2022;8;Vorarlberg;6456546;1123261;5333285;179948
2022;9;Wien;46806825;39467846;7338979;1304534
2022;10;Österreich;150550452;65064959;85485493;4195930
2022;1;Burgenland;4371256;1086050;3285206;121829
2022;2;Kärnten;6111340;1205367;4905973;170327
2022;3;Niederösterreich;28372956;8012694;20360262;790771
2022;4;Oberösterreich;21742383;4783729;16958654;605973
2022;5;Salzburg;9780502;2414578;7365924;272588
2022;6;Steiermark;18606504;4263306;14343198;518574
2022;7;Tirol;8493817;2871554;5622263;236728
2022;8;Vorarlberg;6467281;1131683;5335598;180247
2022;9;Wien;46973605;39631773;7341832;1309182
2022;10;Österreich;150919644;65400734;85518910;4206220
2022;1;Burgenland;4383728;1093737;3289991;122177
2022;2;Kärnten;6117399;1211426;4905973;170496
2022;3;Niederösterreich;28415840;8050250;20365590;791966
2022;4;Oberösterreich;21792488;4820246;16972242;607369
2022;5;Salzburg;9792631;2425764;7366867;272926
2022;6;Steiermark;18643448;4293236;14350212;519604
2022;7;Tirol;8510625;2885669;5624956;237196
2022;8;Vorarlberg;6478553;1140369;5338184;180561
2022;9;Wien;47036495;39690555;7345940;1310935
2022;10;Österreich;151171207;65611252;85559955;4213231
2022;1;Burgenland;4392458;1101719;3290739;122420
2022;2;Kärnten;6126968;1214139;4912829;170762
2022;3;Niederösterreich;28509940;8101870;20408070;794589
2022;4;Oberösterreich;21884307;4854232;17030075;609929
2022;5;Salzburg;9816053;2436899;7379154;273579
2022;6;Steiermark;18683620;4318686;14364934;520724
2022;7;Tirol;8538525;2911444;5627081;237974
2022;8;Vorarlberg;6490949;1147619;5343330;180907
2022;9;Wien;47438236;40089704;7348532;1322132
2022;10;Österreich;151881056;66176312;85704744;4233015
2022;1;Burgenland;4411788;1109947;3301841;122959
2022;2;Kärnten;6140791;1226204;4914587;171147
2022;3;Niederösterreich;28803482;8288740;20514742;802770
2022;4;Oberösterreich;21946608;4893025;17053583;611665
2022;5;Salzburg;9835024;2452543;7382481;274108
2022;6;Steiermark;18769513;4361341;14408172;523117
2022;7;Tirol;8568222;2931235;5636987;238801
2022;8;Vorarlberg;6502109;1154716;5347393;181218
2022;9;Wien;47845622;40495550;7350072;1333486
2022;10;Österreich;152823159;66913301;85909858;4259272
2022;1;Burgenland;4425694;1119151;3306543;123347
2022;2;Kärnten;6147610;1228435;4919175;171338
2022;3;Niederösterreich;29058471;8340482;20717989;809877
2022;4;Oberösterreich;22022761;4926275;17096486;613787
2022;5;Salzburg;9853473;2467919;7385554;274622
2022;6;Steiermark;18809929;4391136;14418793;524244
2022;7;Tirol;8590704;2951977;5638727;239428
2022;8;Vorarlberg;6516524;1164888;5351636;181619
2022;9;Wien;48144858;40792588;7352270;1341826
2022;10;Österreich;153570024;67382851;86187173;4280087
2022;1;Burgenland;4440126;1128168;3311958;123749
2022;2;Kärnten;6154764;1235589;4919175;171537
2022;3;Niederösterreich;29097240;8370864;20726376;810957
2022;4;Oberösterreich;22074982;4964928;17110054;615243
2022;5;Salzburg;9869694;2481333;7388361;275074
2022;6;Steiermark;18846722;4416984;14429738;525269
2022;7;Tirol;8611340;2970733;5640607;240003
2022;8;Vorarlberg;6530689;1174328;5356361;182014
2022;9;Wien;48436267;41082250;7354017;1349947
2022;10;Österreich;154061824;67825177;86236647;4293794
2022;1;Burgenland;4451110;1134979;3316131;124055
2022;2;Kärnten;6170548;1245280;4925268;171977
2022;3;Niederösterreich;29441149;8705345;20735804;820542
2022;4;Oberösterreich;22121255;4997945;17123310;616532
2022;5;Salzburg;9885774;2494318;7391456;275522
2022;6;Steiermark;18890760;4449992;14440768;526497
2022;7;Tirol;8633049;2990919;5642130;240608
2022;8;Vorarlberg;6542080;1182013;5360067;182332
2022;9;Wien;48637415;41281683;7355732;1355553
2022;10;Österreich;154773140;68482474;86290666;4313619
2022;1;Burgenland;4465389;1146813;3318576;124453
2022;2;Kärnten;6174146;1248878;4925268;172077
2022;3;Niederösterreich;29479278;8739047;20740231;821605
2022;4;Oberösterreich;22172066;5031828;17140238;617949
2022;5;Salzburg;9902331;2506846;7395485;275984
2022;6;Steiermark;18930185;4477423;14452762;527595
2022;7;Tirol;8653804;3009695;5644109;241187
2022;8;Vorarlberg;6552488;1188819;5363669;182622
2022;9;Wien;48811516;41454064;7357452;1360406
2022;10;Österreich;155141203;68803413;86337790;4323877
2022;1;Burgenland;4478643;1156966;3321677;124822
2022;2;Kärnten;6179765;1254497;4925268;172234
2022;3;Niederösterreich;29519143;8774605;20744538;822716
2022;4;Oberösterreich;22219606;5061525;17158081;619274
2022;5;Salzburg;9914364;2516960;7397404;276319
2022;6;Steiermark;18957944;4499008;14458936;528369
2022;7;Tirol;8669354;3022529;5646825;241620
2022;8;Vorarlberg;6563320;1196192;5367128;182924
2022;9;Wien;48862022;41502098;7359924;1361813
2022;10;Österreich;155364161;68984380;86379781;4330091
2022;1;Burgenland;4493322;1163405;3329917;125232
2022;2;Kärnten;6189837;1257353;4932484;172514
2022;3;Niederösterreich;29568773;8811785;20756988;824099
2022;4;Oberösterreich;22277309;5095123;17182186;620882
2022;5;Salzburg;9934841;2527134;7407707;276890
2022;6;Steiermark;18995438;4517922;14477516;529414
2022;7;Tirol;8703762;3046172;5657590;242579
2022;8;Vorarlberg;6575575;1202878;5372697;183265
2022;9;Wien;49164993;41800447;7364546;1370257
2022;10;Österreich;155903850;69422219;86481631;4345132
2022;1;Burgenland;4505513;1169700;3335813;125571
2022;2;Kärnten;6201476;1266026;4935450;172839
2022;3;Niederösterreich;29624669;8848302;20776367;825657
2022;4;Oberösterreich;22328154;5123594;17204560;622299
2022;5;Salzburg;9955322;2544148;7411174;277461
2022;6;Steiermark;19082164;4558058;14524106;531831
2022;7;Tirol;8722709;3063401;5659308;243107
2022;8;Vorarlberg;6587642;1210365;5377277;183601
2022;9;Wien;49461150;42092710;7368440;1378511
2022;10;Österreich;156468799;69876304;86592495;4360878
2022;1;Burgenland;4524044;1182390;3341654;126088
2022;2;Kärnten;6210362;1272745;4937617;173086
2022;3;Niederösterreich;30033749;8893291;21140458;837058
2022;4;Oberösterreich;22411222;5158539;17252683;624614
2022;5;Salzburg;9972851;2558224;7414627;277949
2022;6;Steiermark;19121170;4584150;14537020;532918
2022;7;Tirol;8738459;3077363;5661096;243546
2022;8;Vorarlberg;6599847;1217786;5382061;183942
2022;9;Wien;49743194;42370752;7372442;1386372
2022;10;Österreich;157354898;70315240;87039658;4385574
2022;1;Burgenland;4538683;1191454;3347229;126496
2022;2;Kärnten;6215373;1277756;4937617;173226
2022;3;Niederösterreich;30154990;8921663;21233327;840437
2022;4;Oberösterreich;22462965;5192423;17270542;626056
2022;5;Salzburg;9988376;2570247;7418129;278382
2022;6;Steiermark;19156542;4607591;14548951;533904
2022;7;Tirol;8761383;3098472;5662911;244185
2022;8;Vorarlberg;6610872;1224362;5386510;184249
2022;9;Wien;49992345;42616019;7376326;1393316
2022;10;Österreich;157881529;70699987;87181542;4400251
2022;1;Burgenland;4566674;1202570;3364104;127276
2022;2;Kärnten;6223205;1285588;4937617;173444
2022;3;Niederösterreich;30478452;9235845;21242607;849452
2022;4;Oberösterreich;22503719;5215713;17288006;627192
2022;5;Salzburg;10003954;2582155;7421799;278816
2022;6;Steiermark;19199244;4637289;14561955;535094
2022;7;Tirol;8781334;3116756;5664578;244741
2022;8;Vorarlberg;6621649;1230877;5390772;184549
2022;9;Wien;50220579;42840549;7380030;1399677
2022;10;Österreich;158598810;71347342;87251468;4420242
2022;1;Burgenland;4579061;1212867;3366194;127621
2022;2;Kärnten;6233316;1290645;4942671;173726
2022;3;Niederösterreich;30516723;9269908;21246815;850519
2022;4;Oberösterreich;22549788;5245770;17304018;628476
2022;5;Salzburg;10018323;2593090;7425233;279217
2022;6;Steiermark;19233401;4659086;14574315;536046
2022;7;Tirol;8800447;3133990;5666457;245274
2022;8;Vorarlberg;6631505;1237349;5394156;184824
2022;9;Wien;50379094;42995290;7383804;1404095
2022;10;Österreich;158941658;71637995;87303663;4429798
2022;1;Burgenland;4589308;1220520;3368788;127907
2022;2;Kärnten;6235639;1292968;4942671;173791
2022;3;Niederösterreich;30552381;9301809;21250572;851513
2022;4;Oberösterreich;22600374;5277990;17322384;629886
2022;5;Salzburg;10030012;2602769;7427243;279542
2022;6;Steiermark;19260366;4676034;14584332;536798
2022;7;Tirol;8814459;3145460;5668999;245664
2022;8;Vorarlberg;6641146;1243571;5397575;185093
2022;9;Wien;50427856;43039544;7388312;1405454
2022;10;Österreich;159151541;71800665;87350876;4435647
2022;1;Burgenland;4600528;1226109;3374419;128219
2022;2;Kärnten;6238720;1296008;4942712;173877
2022;3;Niederösterreich;30607107;9346023;21261084;853038
2022;4;Oberösterreich;22656619;5310834;17345785;631453
2022;5;Salzburg;10052104;2614763;7437341;280158
2022;6;Steiermark;19305566;4706942;14598624;538058
2022;7;Tirol;8838461;3167407;5671054;246333
2022;8;Vorarlberg;6652575;1249722;5402853;185411
2022;9;Wien;50704949;43313990;7390959;1413177
2022;10;Österreich;159656629;72231798;87424831;4449724
2022;1;Burgenland;4611592;1232813;3378779;128528
2022;2;Kärnten;6245590;1302878;4942712;174068
2022;3;Niederösterreich;30961004;9492058;21468946;862901
2022;4;Oberösterreich;22697776;5333083;17364693;632600
2022;5;Salzburg;10070098;2629076;7441022;280660
2022;6;Steiermark;19345418;4735325;14610093;539168
2022;7;Tirol;8864497;3184382;5680115;247059
2022;8;Vorarlberg;6664855;1257520;5407335;185753
2022;9;Wien;51042999;43650051;7392948;1422598
2022;10;Österreich;160503829;72817186;87686643;4473336
2022;1;Burgenland;4626761;1244164;3382597;128951
2022;2;Kärnten;6264602;1310323;4954279;174598
2022;3;Niederösterreich;31303849;9529795;21774054;872457
2022;4;Oberösterreich;22767886;5360840;17407046;634554
2022;5;Salzburg;10085786;2641455;7444331;281097
2022;6;Steiermark;19409586;4758962;14650624;540957
2022;7;Tirol;8885261;3203357;5681904;247637
2022;8;Vorarlberg;6676232;1264653;5411579;186071
2022;9;Wien;51285162;43890184;7394978;1429348
2022;10;Österreich;161305125;73203733;88101392;4495669
2022;1;Burgenland;4639604;1253166;3386438;129309
2022;2;Kärnten;6277919;1314010;4963909;174969
2022;3;Niederösterreich;31336870;9555790;21781080;873377
2022;4;Oberösterreich;22815447;5393001;17422446;635880
2022;5;Salzburg;10102022;2654185;7447837;281549
2022;6;Steiermark;19444275;4782702;14661573;541923
2022;7;Tirol;8903384;3219728;5683656;248143
2022;8;Vorarlberg;6686897;1270996;5415901;186368
2022;9;Wien;51315931;43919550;7396381;1430205
2022;10;Österreich;161522349;73363128;88159221;4501723
2022;1;Burgenland;4654466;1262876;3391590;129723
2022;2;Kärnten;6285287;1320569;4964718;175175
2022;3;Niederösterreich;31639551;9850672;21788879;881813
2022;4;Oberösterreich;22856087;5418431;17437656;637013
2022;5;Salzburg;10116557;2665150;7451407;281954
2022;6;Steiermark;19477458;4804235;14673223;542848
2022;7;Tirol;8921682;3236583;5685099;248653
2022;8;Vorarlberg;6697538;1277627;5419911;186664
2022;9;Wien;51699358;44300051;7399307;1440892
2022;10;Österreich;162347984;74136194;88211790;4524734
2022;1;Burgenland;4668546;1272513;3396033;130115
2022;2;Kärnten;6289437;1324719;4964718;175290
2022;3;Niederösterreich;31674025;9879696;21794329;882774
2022;4;Oberösterreich;22887087;5441771;17445316;637877
2022;5;Salzburg;10128343;2675115;7453228;282283
2022;6;Steiermark;19509297;4828842;14680455;543736
2022;7;Tirol;8937273;3251090;5686183;249087
2022;8;Vorarlberg;6705125;1283498;5421627;186876
2022;9;Wien;51856896;44455269;7401627;1445282
2022;10;Österreich;162656029;74412513;88243516;4533319
2022;1;Burgenland;4679338;1281003;3398335;130416
2022;2;Kärnten;6292674;1327595;4965079;175381
2022;3;Niederösterreich;31712357;9912895;21799462;883842
2022;4;Oberösterreich;22918100;5463659;17454441;638741
2022;5;Salzburg;10137803;2684007;7453796;282547
2022;6;Steiermark;19532189;4846444;14685745;544374
2022;7;Tirol;8948601;3260675;5687926;249403
2022;8;Vorarlberg;6713396;1289983;5423413;187106
2022;9;Wien;51902717;44498279;7404438;1446559
2022;10;Österreich;162837175;74564540;88272635;4538368
2022;1;Burgenland;4695828;1286908;3408920;130875
2022;2;Kärnten;6304144;1331356;4972788;175700
2022;3;Niederösterreich;31781251;9946393;21834858;885762
2022;4;Oberösterreich;22964919;5496147;17468772;640046
2022;5;Salzburg;10154622;2693495;7461127;283015
2022;6;Steiermark;19562982;4868797;14694185;545232
2022;7;Tirol;8972263;3282901;5689362;250062
2022;8;Vorarlberg;6723977;1297097;5426880;187401
2022;9;Wien;52304630;44897229;7407401;1457761
2022;10;Österreich;163464616;75100323;88364293;4555855
2022;1;Burgenland;4706724;1294595;3412129;131179
2022;2;Kärnten;6311359;1337718;4973641;175901
2022;3;Niederösterreich;31885412;9973833;21911579;888665
2022;4;Oberösterreich;23002676;5521866;17480810;641098
2022;5;Salzburg;10167924;2704964;7462960;283386
2022;6;Steiermark;19629565;4898209;14731356;547088
2022;7;Tirol;8989988;3299393;5690595;250556
2022;8;Vorarlberg;6734870;1304749;5430121;187705
2022;9;Wien;52645283;45235318;7409965;1467255
2022;10;Österreich;164073801;75570645;88503156;4572834
2022;1;Burgenland;4720958;1305786;3415172;131576
2022;2;Kärnten;6321600;1343527;4978073;176187
2022;3;Niederösterreich;32207075;10011120;22195955;897630
2022;4;Oberösterreich;23056771;5542917;17513854;642606
2022;5;Salzburg;10180681;2715811;7464870;283742
2022;6;Steiermark;19662740;4922632;14740108;548012
2022;7;Tirol;9009009;3317149;5691860;251086
2022;8;Vorarlberg;6743669;1310729;5432940;187950
2022;9;Wien;52974412;45562270;7412142;1476428
2022;10;Österreich;164876915;76031941;88844974;4595217
2022;1;Burgenland;4732903;1314580;3418323;131909
2022;2;Kärnten;6326357;1348284;4978073;176319
2022;3;Niederösterreich;32238864;10035465;22203399;898516
2022;4;Oberösterreich;23090450;5568741;17521709;643544
2022;5;Salzburg;10195415;2728915;7466500;284152
2022;6;Steiermark;19697947;4948451;14749496;548993
2022;7;Tirol;9025508;3332543;5692965;251546
2022;8;Vorarlberg;6755308;1319756;5435552;188274
2022;9;Wien;53284695;45870289;7414406;1485076
2022;10;Österreich;165347447;76467024;88880423;4608331
2022;1;Burgenland;4760814;1326037;3434777;132687
2022;2;Kärnten;6331997;1353924;4978073;176476
2022;3;Niederösterreich;32514929;10302915;22212014;906210
2022;4;Oberösterreich;23125285;5596212;17529073;644515
2022;5;Salzburg;10207263;2739026;7468237;284482
2022;6;Steiermark;19730085;4971389;14758696;549889
2022;7;Tirol;9043292;3349273;5694019;252042
2022;8;Vorarlberg;6765351;1327342;5438009;188554
2022;9;Wien;53532619;46116418;7416201;1491986
2022;10;Österreich;166011635;77082536;88929099;4626842
2022;1;Burgenland;4769933;1333938;3435995;132941
2022;2;Kärnten;6335180;1357107;4978073;176565
2022;3;Niederösterreich;32552933;10337866;22215067;907269
2022;4;Oberösterreich;23152452;5617758;17534694;645272
2022;5;Salzburg;10218955;2749305;7469650;284808
2022;6;Steiermark;19756262;4990498;14765764;550619
2022;7;Tirol;9059300;3364213;5695087;252488
2022;8;Vorarlberg;6773498;1333958;5439540;188781
2022;9;Wien;53759794;46341932;7417862;1498317
2022;10;Österreich;166378307;77426575;88951732;4637062
2022;1;Burgenland;4780115;1342037;3438078;133225
2022;2;Kärnten;6342402;1360107;4982295;176766
2022;3;Niederösterreich;32582449;10364824;22217625;908092
2022;4;Oberösterreich;23185145;5642320;17542825;646184
2022;5;Salzburg;10226785;2756671;7470114;285027
2022;6;Steiermark;19782498;5011481;14771017;551350
2022;7;Tirol;9071965;3375196;5696769;252841
2022;8;Vorarlberg;6782493;1341234;5441259;189032
2022;9;Wien;53969738;46549455;7420283;1504168
2022;10;Österreich;166723590;77743325;88980265;4646685
2022;1;Burgenland;4793429;1351587;3441842;133596
2022;2;Kärnten;6356459;1363512;4992947;177158
2022;3;Niederösterreich;32643128;10396538;22246590;909783
2022;4;Oberösterreich;23219191;5665765;17553426;647133
2022;5;Salzburg;10262711;2764612;7498099;286028
2022;6;Steiermark;19812777;5030960;14781817;552194
2022;7;Tirol;9106530;3395001;5711529;253804
2022;8;Vorarlberg;6793974;1349634;5444340;189352
2022;9;Wien;54280070;46857246;7422824;1512818
2022;10;Österreich;167268269;78174855;89093414;4661865
2022;1;Burgenland;4801960;1357168;3444792;133833
2022;2;Kärnten;6362424;1369264;4993160;177325
2022;3;Niederösterreich;33210108;10682947;22527161;925585
2022;4;Oberösterreich;23252699;5689704;17562995;648066
2022;5;Salzburg;10279156;2779312;7499844;286486
2022;6;Steiermark;19868149;5052260;14815889;553737
2022;7;Tirol;9124558;3411971;5712587;254307
2022;8;Vorarlberg;6806748;1359862;5446886;189708
2022;9;Wien;54619617;47194768;7424849;1522281
2022;10;Österreich;168325419;78897256;89428163;4691329
2022;1;Burgenland;4815693;1367788;3447905;134216
2022;2;Kärnten;6370886;1374432;4996454;177560
2022;3;Niederösterreich;33521861;10720383;22801478;934274
2022;4;Oberösterreich;23278596;5709492;17569104;648788
2022;5;Salzburg;10293005;2791529;7501476;286872
2022;6;Steiermark;19912776;5089115;14823661;554981
2022;7;Tirol;9142175;3428439;5713736;254798
2022;8;Vorarlberg;6818126;1368795;5449331;190025
2022;9;Wien;54940896;47513982;7426914;1531235
2022;10;Österreich;169094014;79363955;89730059;4712750
2022;1;Burgenland;4825377;1374968;3450409;134486
2022;2;Kärnten;6379050;1379441;4999609;177788
2022;3;Niederösterreich;33555497;10748092;22807405;935211
2022;4;Oberösterreich;23335348;5734229;17601119;650370
2022;5;Salzburg;10306086;2803119;7502967;287237
2022;6;Steiermark;19946415;5116231;14830184;555918
2022;7;Tirol;9158131;3443283;5714848;255243
2022;8;Vorarlberg;6828313;1376726;5451587;190309
2022;9;Wien;55232056;47803346;7428710;1539350
2022;10;Österreich;169566273;79779435;89786838;4725912
2022;1;Burgenland;4858816;1392277;3466539;135418
2022;2;Kärnten;6386876;1386010;5000866;178006
2022;3;Niederösterreich;33807219;10991611;22815608;942227
2022;4;Oberösterreich;23363570;5756955;17606615;651156
2022;5;Salzburg;10315495;2811005;7504490;287499
2022;6;Steiermark;19973728;5136512;14837216;556680
2022;7;Tirol;9173573;3457774;5715799;255673
2022;8;Vorarlberg;6838116;1384288;5453828;190582
2022;9;Wien;55563807;48133227;7430580;1548596
2022;10;Österreich;170281200;80449659;89831541;4745838
2022;1;Burgenland;4869057;1401410;3467647;135703
2022;2;Kärnten;6390259;1389393;5000866;178100
2022;3;Niederösterreich;33840357;11021783;22818574;943151
2022;4;Oberösterreich;23386323;5775912;17610411;651791
2022;5;Salzburg;10324706;2819218;7505488;287756
2022;6;Steiermark;20003431;5160589;14842842;557507
2022;7;Tirol;9187552;3470732;5716820;256062
2022;8;Vorarlberg;6845936;1390833;5455103;190800
2022;9;Wien;55785608;48353494;7432114;1554778
2022;10;Österreich;170633229;80783364;89849865;4755649
2022;1;Burgenland;4880409;1411042;3469367;136020
2022;2;Kärnten;6393285;1392033;5001252;178185
2022;3;Niederösterreich;33876245;11055637;22820608;944151
2022;4;Oberösterreich;23413213;5798258;17614955;652540
2022;5;Salzburg;10333381;2827497;7505884;287997
2022;6;Steiermark;20025723;5178518;14847205;558129
2022;7;Tirol;9198806;3480581;5718225;256376
2022;8;Vorarlberg;6854229;1397654;5456575;191031
2022;9;Wien;55990511;48556068;7434443;1560489
2022;10;Österreich;170965802;81097288;89868514;4764918
2022;1;Burgenland;4892728;1420028;3472700;136363
2022;2;Kärnten;6396801;1395549;5001252;178283
2022;3;Niederösterreich;33940129;11090210;22849919;945931
2022;4;Oberösterreich;23444183;5819503;17624680;653403
2022;5;Salzburg;10347523;2837640;7509883;288392
2022;6;Steiermark;20053254;5197668;14855586;558896
2022;7;Tirol;9218153;3498694;5719459;256915
2022;8;Vorarlberg;6864836;1405398;5459438;191327
2022;9;Wien;56258318;48821376;7436942;1567953
2022;10;Österreich;171415925;81486066;89929859;4777463
2022;1;Burgenland;4903146;1427938;3475208;136654
2022;2;Kärnten;6411330;1401145;5010185;178688
2022;3;Niederösterreich;33989796;11122498;22867298;947316
2022;4;Oberösterreich;23475218;5842029;17633189;654268
2022;5;Salzburg;10363211;2851828;7511383;288829
2022;6;Steiermark;20108448;5225549;14882899;560434
2022;7;Tirol;9238608;3512472;5726136;257485
2022;8;Vorarlberg;6876399;1414330;5462069;191649
2022;9;Wien;56528088;49089300;7438788;1575471
2022;10;Österreich;171894244;81887089;90007155;4790794
2022;1;Burgenland;4917684;1440086;3477598;137059
2022;2;Kärnten;6417616;1405377;5012239;178863
2022;3;Niederösterreich;34280317;11157807;23122510;955413
2022;4;Oberösterreich;23521776;5855759;17666017;655566
2022;5;Salzburg;10372586;2859929;7512657;289090
2022;6;Steiermark;20137237;5248644;14888593;561237
2022;7;Tirol;9251815;3524806;5727009;257854
2022;8;Vorarlberg;6886046;1421835;5464211;191918
2022;9;Wien;56773050;49332360;7440690;1582298
2022;10;Österreich;172558127;82246603;90311524;4809297
2022;1;Burgenland;4928278;1448355;3479923;137354
2022;2;Kärnten;6423688;1408931;5014757;179032
2022;3;Niederösterreich;34313003;11182341;23130662;956324
2022;4;Oberösterreich;23549696;5878219;17671477;656344
2022;5;Salzburg;10385680;2871888;7513792;289455
2022;6;Steiermark;20159840;5266057;14893783;561867
2022;7;Tirol;9263953;3536024;5727929;258192
2022;8;Vorarlberg;6894273;1427928;5466345;192147
2022;9;Wien;56986441;49543858;7442583;1588246
2022;10;Österreich;172904852;82563601;90341251;4818960
2022;1;Burgenland;4942089;1456498;3485591;137739
2022;2;Kärnten;6428982;1413272;5015710;179180
2022;3;Niederösterreich;34589637;11338298;23251339;964034
2022;4;Oberösterreich;23569943;5892702;17677241;656908
2022;5;Salzburg;10395585;2880453;7515132;289731
2022;6;Steiermark;20181228;5281718;14899510;562463
2022;7;Tirol;9276486;3547682;5728804;258541
2022;8;Vorarlberg;6903012;1434372;5468640;192391
2022;9;Wien;57219997;49775546;7444451;1594755
2022;10;Österreich;173506959;83020541;90486418;4835741
2022;1;Burgenland;4951175;1464476;3486699;137992
2022;2;Kärnten;6431488;1415778;5015710;179249
2022;3;Niederösterreich;34621915;11368119;23253796;964933
2022;4;Oberösterreich;23594268;5910951;17683317;657586
2022;5;Salzburg;10401933;2885579;7516354;289908
2022;6;Steiermark;20201551;5297176;14904375;563029
2022;7;Tirol;9287770;3558109;5729661;258856
2022;8;Vorarlberg;6909207;1438954;5470253;192564
2022;9;Wien;57293731;49847857;7445874;1596810
2022;10;Österreich;173693038;83186999;90506039;4840927
2022;1;Burgenland;4959447;1471411;3488036;138223
2022;2;Kärnten;6434490;1418780;5015710;179333
2022;3;Niederösterreich;34650469;11394922;23255547;965729
2022;4;Oberösterreich;23615060;5927559;17687501;658166
2022;5;Salzburg;10407120;2890317;7516803;290053
2022;6;Steiermark;20216084;5308765;14907319;563434
2022;7;Tirol;9295726;3564963;5730763;259077
2022;8;Vorarlberg;6915610;1444083;5471527;192742
2022;9;Wien;57421128;49973164;7447964;1600361
2022;10;Österreich;173915134;83393964;90521170;4847117
2022;1;Burgenland;4968787;1477778;3491009;138483
2022;2;Kärnten;6444006;1422836;5021170;179598
2022;3;Niederösterreich;34812654;11426810;23385844;970249
2022;4;Oberösterreich;23640629;5943410;17697219;658878
2022;5;Salzburg;10418857;2897697;7521160;290380
2022;6;Steiermark;20235795;5322913;14912882;563984
2022;7;Tirol;9308825;3577117;5731708;259442
2022;8;Vorarlberg;6923353;1449188;5474165;192958
2022;9;Wien;57688663;50238483;7450180;1607817
2022;10;Österreich;174441569;83756232;90685337;4861789
2022;1;Burgenland;4978412;1485273;3493139;138751
2022;2;Kärnten;6450039;1426278;5023761;179766
2022;3;Niederösterreich;35294548;11760814;23533734;983680
2022;4;Oberösterreich;23661944;5957472;17704472;659472
2022;5;Salzburg;10429131;2906990;7522141;290666
2022;6;Steiermark;20275774;5337811;14937963;565098
2022;7;Tirol;9319455;3586991;5732464;259739
2022;8;Vorarlberg;6930496;1454355;5476141;193157
2022;9;Wien;57907581;50451208;7456373;1613918
2022;10;Österreich;175247380;84367192;90880188;4884248
2022;1;Burgenland;4987787;1492559;3495228;139013
2022;2;Kärnten;6457038;1428388;5028650;179961
2022;3;Niederösterreich;35328896;11790276;23538620;984637
2022;4;Oberösterreich;23698936;5967446;17731490;660503
2022;5;Salzburg;10437104;2913919;7523185;290888
2022;6;Steiermark;20296100;5353655;14942445;565664
2022;7;Tirol;9329084;3595864;5733220;260007
2022;8;Vorarlberg;6936946;1458854;5478092;193337
2022;9;Wien;58145396;50682731;7462665;1620546
2022;10;Österreich;175617287;84683692;90933595;4894557
2022;1;Burgenland;4997066;1499754;3497312;139271
2022;2;Kärnten;6461076;1432426;5028650;180074
2022;3;Niederösterreich;35588052;11813644;23774408;991860
2022;4;Oberösterreich;23714720;5978851;17735869;660943
2022;5;Salzburg;10445373;2921075;7524298;291119
2022;6;Steiermark;20309642;5362398;14947244;566042
2022;7;Tirol;9338646;3604728;5733918;260274
2022;8;Vorarlberg;6942575;1462608;5479967;193494
2022;9;Wien;58372512;50903633;7468879;1626876
2022;10;Österreich;176169662;84979117;91190545;4909952
2022;1;Burgenland;5006967;1508053;3498914;139547
2022;2;Kärnten;6465189;1435804;5029385;180189
2022;3;Niederösterreich;35818620;12040145;23778475;998286
2022;4;Oberösterreich;23730500;5991417;17739083;661383
2022;5;Salzburg;10451220;2926294;7524926;291282
2022;6;Steiermark;20318900;5370785;14948115;566300
2022;7;Tirol;9345231;3611313;5733918;260457
2022;8;Vorarlberg;6946801;1465325;5481476;193611
2022;9;Wien;58546572;51071293;7475279;1631728
2022;10;Österreich;176630000;85420429;91209571;4922782
2022;1;Burgenland;5011041;1511706;3499335;139661
2022;2;Kärnten;6467203;1437818;5029385;180245
2022;3;Niederösterreich;35856245;12068394;23787851;999335
2022;4;Oberösterreich;23746530;6003582;17742948;661830
2022;5;Salzburg;10455617;2929958;7525659;291404
2022;6;Steiermark;20321345;5372164;14949181;566368
2022;7;Tirol;9351225;3617307;5733918;260624
2022;8;Vorarlberg;6950554;1468094;5482460;193716
2022;9;Wien;58683870;51202285;7481585;1635554
2022;10;Österreich;176843630;85611308;91232322;4928736
2022;1;Burgenland;5014024;1514249;3499775;139744
2022;2;Kärnten;6469307;1439922;5029385;180303
2022;3;Niederösterreich;35881545;12089434;23792111;1000040
2022;4;Oberösterreich;23757403;6011851;17745552;662133
2022;5;Salzburg;10458493;2932308;7526185;291484
2022;6;Steiermark;20325091;5375180;14949911;566472
2022;7;Tirol;9355038;3621120;5733918;260730
2022;8;Vorarlberg;6954276;1470978;5483298;193820
2022;9;Wien;58816499;51328225;7488274;1639251
2022;10;Österreich;177031676;85783267;91248409;4933977
2022;1;Burgenland;5019951;1518493;3501458;139909
2022;2;Kärnten;6476526;1443063;5033463;180505
2022;3;Niederösterreich;35924877;12115580;23809297;1001248
2022;4;Oberösterreich;23773165;6019371;17753794;662572
2022;5;Salzburg;10462545;2937211;7525334;291597
2022;6;Steiermark;20349370;5395959;14953411;567149
2022;7;Tirol;9364662;3630744;5733918;260999
2022;8;Vorarlberg;6958657;1473354;5485303;193942
2022;9;Wien;59076246;51580686;7495560;1646490
2022;10;Österreich;177405999;86114461;91291538;4944410
2022;1;Burgenland;5027959;1525367;3502592;140132
2022;2;Kärnten;6478957;1445494;5033463;180572
2022;3;Niederösterreich;35956447;12137058;23819389;1002127
2022;4;Oberösterreich;23783645;6025705;17757940;662864
2022;5;Salzburg;10467008;2941161;7525847;291722
2022;6;Steiermark;20431748;5409722;15022026;569445
2022;7;Tirol;9385146;3640312;5744834;261570
2022;8;Vorarlberg;6963187;1476207;5486980;194068
2022;9;Wien;59271312;51773689;7497623;1651926
2022;10;Österreich;177765409;86374715;91390694;4954427
2022;1;Burgenland;5036496;1532890;3503606;140370
2022;2;Kärnten;6486392;1447991;5038401;180780
2022;3;Niederösterreich;36367374;12239905;24127469;1013580
2022;4;Oberösterreich;23816208;6030651;17785557;663772
2022;5;Salzburg;10471085;2944653;7526432;291835
2022;6;Steiermark;20444540;5420943;15023597;569801
2022;7;Tirol;9393458;3648624;5744834;261801
2022;8;Vorarlberg;6967258;1478568;5488690;194182
2022;9;Wien;59503618;52003791;7499827;1658401
2022;10;Österreich;178486429;86748016;91738413;4974522
2022;1;Burgenland;5041869;1537273;3504596;140520
2022;2;Kärnten;6488391;1449990;5038401;180835
2022;3;Niederösterreich;36387560;12257611;24129949;1014143
2022;4;Oberösterreich;23826623;6038704;17787919;664062
2022;5;Salzburg;10474907;2947859;7527048;291942
2022;6;Steiermark;20456881;5431788;15025093;570145
2022;7;Tirol;9399448;3654614;5744834;261968
2022;8;Vorarlberg;6970911;1480605;5490306;194283
2022;9;Wien;59632358;52129138;7503220;1661989
2022;10;Österreich;178678948;86927582;91751366;4979888
2022;1;Burgenland;5051356;1543477;3507879;140784
2022;2;Kärnten;6489938;1451496;5038442;180878
2022;3;Niederösterreich;36726583;12476857;24249726;1023592
2022;4;Oberösterreich;23836125;6045211;17790914;664327
2022;5;Salzburg;10478242;2950551;7527691;292035
2022;6;Steiermark;20467815;5440953;15026862;570450
2022;7;Tirol;9404546;3659712;5744834;262110
2022;8;Vorarlberg;6974653;1482668;5491985;194388
2022;9;Wien;59766035;52259628;7506407;1665715
2022;10;Österreich;179195293;87310553;91884740;4994279
2022;1;Burgenland;5055655;1547400;3508255;140904
2022;2;Kärnten;6493552;1452779;5040773;180979
2022;3;Niederösterreich;36742904;12491922;24250982;1024046
2022;4;Oberösterreich;23845939;6051396;17794543;664600
2022;5;Salzburg;10481328;2952868;7528460;292121
2022;6;Steiermark;20480125;5451651;15028474;570793
2022;7;Tirol;9408928;3664094;5744834;262232
2022;8;Vorarlberg;6977640;1484533;5493107;194471
2022;9;Wien;59879684;52370398;7509286;1668882
2022;10;Österreich;179365755;87467041;91898714;4999029
2022;1;Burgenland;5059645;1551177;3508468;141015
2022;2;Kärnten;6495086;1454201;5040885;181022
2022;3;Niederösterreich;36757348;12505653;24251695;1024449
2022;4;Oberösterreich;23852590;6055636;17796954;664786
2022;5;Salzburg;10483628;2954723;7528905;292185
2022;6;Steiermark;20483667;5454421;15029246;570892
2022;7;Tirol;9411351;3666517;5744834;262300
2022;8;Vorarlberg;6980415;1486345;5494070;194548
2022;9;Wien;59942102;52429994;7512108;1670622
2022;10;Österreich;179465832;87558667;91907165;5001819
2022;1;Burgenland;5061737;1552287;3509450;141074
2022;2;Kärnten;6499434;1456609;5042825;181143
2022;3;Niederösterreich;36777411;12521809;24255602;1025008
2022;4;Oberösterreich;23924081;6061862;17862219;666778
2022;5;Salzburg;10486997;2957789;7529208;292279
2022;6;Steiermark;20490220;5459284;15030936;571075
2022;7;Tirol;9417268;3672434;5744834;262465
2022;8;Vorarlberg;6983678;1487814;5495864;194639
2022;9;Wien;60026534;52511459;7515075;1672975
2022;10;Österreich;179667360;87681347;91986013;5007435
2022;1;Burgenland;5067417;1557094;3510323;141232
2022;2;Kärnten;6504141;1458230;5045911;181274
2022;3;Niederösterreich;36795949;12537299;24258650;1025525
2022;4;Oberösterreich;23933679;6066070;17867609;667046
2022;5;Salzburg;10490213;2960457;7529756;292368
2022;6;Steiermark;20520780;5470368;15050412;571926
2022;7;Tirol;9421562;3676728;5744834;262584
2022;8;Vorarlberg;6987006;1489787;5497219;194732
2022;9;Wien;60132565;52614904;7517661;1675930
2022;10;Österreich;179853312;87830937;92022375;5012618
2022;1;Burgenland;5073181;1562227;3510954;141393
2022;2;Kärnten;6506919;1460120;5046799;181352
2022;3;Niederösterreich;36915253;12551969;24363284;1028850
2022;4;Oberösterreich;23959271;6070438;17888833;667759
2022;5;Salzburg;10493197;2962924;7530273;292452
2022;6;Steiermark;20529702;5477928;15051774;572175
2022;7;Tirol;9425870;3681036;5744834;262705
2022;8;Vorarlberg;6989982;1491319;5498663;194815
2022;9;Wien;60222322;52702247;7520075;1678432
2022;10;Österreich;180115697;87960208;92155489;5019931
2022;1;Burgenland;5076783;1565266;3511517;141493
2022;2;Kärnten;6508693;1461628;5047065;181401
2022;3;Niederösterreich;36929021;12563041;24365980;1029234
2022;4;Oberösterreich;23966620;6075994;17890626;667964
2022;5;Salzburg;10496102;2965316;7530786;292533
2022;6;Steiermark;20539158;5486133;15053025;572438
2022;7;Tirol;9429665;3684831;5744834;262810
2022;8;Vorarlberg;6992622;1492725;5499897;194889
2022;9;Wien;60306678;52784867;7521811;1680783
2022;10;Österreich;180245342;88079801;92165541;5023544
2022;1;Burgenland;5078787;1566397;3512390;141549
2022;2;Kärnten;6510219;1463140;5047079;181444
2022;3;Niederösterreich;37050326;12630790;24419536;1032614
2022;4;Oberösterreich;23972845;6080336;17892509;668137
2022;5;Salzburg;10499094;2967878;7531216;292616
2022;6;Steiermark;20548514;5494219;15054295;572699
2022;7;Tirol;9433563;3688729;5744834;262919
2022;8;Vorarlberg;6994897;1493982;5500915;194952
2022;9;Wien;60383700;52860268;7523432;1682929
2022;10;Österreich;180471945;88245739;92226206;5029860
2022;1;Burgenland;5084838;1572321;3512517;141717
2022;2;Kärnten;6510880;1463801;5047079;181462
2022;3;Niederösterreich;37061076;12641096;24419980;1032914
2022;4;Oberösterreich;23978414;6084504;17893910;668293
2022;5;Salzburg;10501617;2969990;7531627;292686
2022;6;Steiermark;20558143;5503043;15055100;572968
2022;7;Tirol;9436985;3692151;5744834;263014
2022;8;Vorarlberg;6996893;1495378;5501515;195008
2022;9;Wien;60449316;52924300;7525016;1684758
2022;10;Österreich;180578162;88346584;92231578;5032820
2022;1;Burgenland;5088442;1575584;3512858;141818
2022;2;Kärnten;6511412;1464333;5047079;181477
2022;3;Niederösterreich;37069614;12649189;24420425;1033152
2022;4;Oberösterreich;23984049;6088427;17895622;668450
2022;5;Salzburg;10503285;2971246;7532039;292733
2022;6;Steiermark;20561157;5505419;15055738;573052
2022;7;Tirol;9438678;3693844;5744834;263062
2022;8;Vorarlberg;6998698;1496644;5502054;195058
2022;9;Wien;60502599;52975918;7526681;1686243
2022;10;Österreich;180657934;88420604;92237330;5035043
2022;1;Burgenland;5090456;1577339;3513117;141874
2022;2;Kärnten;6512585;1465506;5047079;181510
2022;3;Niederösterreich;37078182;12657282;24420900;1033391
2022;4;Oberösterreich;23991410;6093174;17898236;668655
2022;5;Salzburg;10505154;2972628;7532526;292785
2022;6;Steiermark;20566463;5509728;15056735;573199
2022;7;Tirol;9440846;3696012;5744834;263122
2022;8;Vorarlberg;7000402;1497522;5502880;195105
2022;9;Wien;60574346;53045442;7528904;1688243
2022;10;Österreich;180759844;88514633;92245211;5037884
2022;1;Burgenland;5093745;1579960;3513785;141966
2022;2;Kärnten;6518260;1467830;5050430;181668
2022;3;Niederösterreich;37098722;12669242;24429480;1033963
2022;4;Oberösterreich;24002901;6097545;17905356;668975
2022;5;Salzburg;10508889;2975679;7533210;292889
2022;6;Steiermark;20583230;5515805;15067425;573667
2022;7;Tirol;9445864;3701030;5744834;263262
2022;8;Vorarlberg;7003185;1498447;5504738;195183
2022;9;Wien;60753001;53222153;7530848;1693222
2022;10;Österreich;181007797;88727691;92280106;5044794
2022;1;Burgenland;5103592;1587666;3515926;142240
2022;2;Kärnten;6524096;1470006;5054090;181830
2022;3;Niederösterreich;37219322;12727357;24491965;1037324
2022;4;Oberösterreich;24022269;6100328;17921941;669515
2022;5;Salzburg;10511659;2978003;7533656;292966
2022;6;Steiermark;20594417;5525604;15068813;573979
2022;7;Tirol;9449715;3704881;5744834;263369
2022;8;Vorarlberg;7006195;1500092;5506103;195267
2022;9;Wien;60920825;53389015;7531810;1697899
2022;10;Österreich;181352090;88982952;92369138;5054390
2022;1;Burgenland;5107503;1591121;3516382;142349
2022;2;Kärnten;6525667;1471364;5054303;181874
2022;3;Niederösterreich;37342949;12845654;24497295;1040770
2022;4;Oberösterreich;24028468;6104798;17923670;669688
2022;5;Salzburg;10514044;2979976;7534068;293033
2022;6;Steiermark;20603530;5533504;15070026;574233
2022;7;Tirol;9452915;3708081;5744834;263458
2022;8;Vorarlberg;7008586;1501063;5507523;195333
2022;9;Wien;61027430;53494765;7532665;1700870
2022;10;Österreich;181611092;89230326;92380766;5061608
2022;1;Burgenland;5112133;1594876;3517257;142478
2022;2;Kärnten;6526910;1472397;5054513;181909
2022;3;Niederösterreich;37355298;12854730;24500568;1041114
2022;4;Oberösterreich;24034483;6109047;17925436;669855
2022;5;Salzburg;10516294;2981804;7534490;293095
2022;6;Steiermark;20611051;5539851;15071200;574442
2022;7;Tirol;9456058;3711224;5744834;263546
2022;8;Vorarlberg;7010916;1502205;5508711;195398
2022;9;Wien;61101167;53567534;7533633;1702926
2022;10;Österreich;181724310;89333668;92390642;5064764
2022;1;Burgenland;5115391;1597873;3517518;142569
2022;2;Kärnten;6527677;1473146;5054531;181930
2022;3;Niederösterreich;37366953;12865949;24501004;1041439
2022;4;Oberösterreich;24039624;6112649;17926975;669999
2022;5;Salzburg;10518162;2983362;7534800;293147
2022;6;Steiermark;20618075;5546204;15071871;574638
2022;7;Tirol;9458613;3713779;5744834;263617
2022;8;Vorarlberg;7012055;1502861;5509194;195430
2022;9;Wien;61169184;53634866;7534318;1704821
2022;10;Österreich;181825734;89430689;92395045;5067590
2022;1;Burgenland;5118684;1601027;3517657;142661
2022;2;Kärnten;6528737;1474110;5054627;181960
2022;3;Niederösterreich;37374565;12873206;24501359;1041651
2022;4;Oberösterreich;24044431;6116154;17928277;670132
2022;5;Salzburg;10519126;2984004;7535122;293174
2022;6;Steiermark;20620990;5548497;15072493;574719
2022;7;Tirol;9460284;3715450;5744834;263664
2022;8;Vorarlberg;7013417;1503617;5509800;195468
2022;9;Wien;61230227;53695052;7535175;1706523
2022;10;Österreich;181910461;89511117;92399344;5069952
2022;1;Burgenland;5121074;1602646;3518428;142727
2022;2;Kärnten;6532664;1475876;5056788;182069
2022;3;Niederösterreich;37470334;12882605;24587729;1044320
2022;4;Oberösterreich;24055624;6120592;17935032;670444
2022;5;Salzburg;10522737;2987050;7535687;293275
2022;6;Steiermark;20627442;5553419;15074023;574899
2022;7;Tirol;9464662;3719828;5744834;263786
2022;8;Vorarlberg;7016261;1504845;5511416;195547
2022;9;Wien;61368745;53832380;7536365;1710383
2022;10;Österreich;182179543;89679241;92500302;5077451
2022;1;Burgenland;5125684;1606690;3518994;142856
2022;2;Kärnten;6534553;1477285;5057268;182122
2022;3;Niederösterreich;37488396;12894048;24594348;1044824
2022;4;Oberösterreich;24061590;6123625;17937965;670611
2022;5;Salzburg;10525179;2989034;7536145;293343
2022;6;Steiermark;20656297;5562771;15093526;575703
2022;7;Tirol;9467945;3723111;5744834;263877
2022;8;Vorarlberg;7018642;1505852;5512790;195614
2022;9;Wien;61538112;54000916;7537196;1715103
2022;10;Österreich;182416398;89883332;92533066;5084053
2022;1;Burgenland;5130895;1611507;3519388;143001
2022;2;Kärnten;6538539;1478808;5059731;182233
2022;3;Niederösterreich;37497926;12902590;24595336;1045089
2022;4;Oberösterreich;24084660;6126660;17958000;671254
2022;5;Salzburg;10527404;2990831;7536573;293405
2022;6;Steiermark;20664103;5569286;15094817;575921
2022;7;Tirol;9470950;3726116;5744834;263961
2022;8;Vorarlberg;7020706;1506692;5514014;195671
2022;9;Wien;61661060;54122942;7538118;1718530
2022;10;Österreich;182596243;90035432;92560811;5089065
2022;1;Burgenland;5134010;1614253;3519757;143088
2022;2;Kärnten;6539873;1480121;5059752;182270
2022;3;Niederösterreich;37620099;13023874;24596225;1048494
2022;4;Oberösterreich;24090610;6130968;17959642;671420
2022;5;Salzburg;10529754;2992703;7537051;293470
2022;6;Steiermark;20672903;5576904;15095999;576166
2022;7;Tirol;9473609;3728775;5744834;264035
2022;8;Vorarlberg;7022811;1507574;5515237;195730
2022;9;Wien;61758717;54219779;7538938;1721252
2022;10;Österreich;182842386;90274951;92567435;5095925
2022;1;Burgenland;5138598;1617161;3521437;143216
2022;2;Kärnten;6540770;1480954;5059816;182295
2022;3;Niederösterreich;37673357;13074377;24598980;1049979
2022;4;Oberösterreich;24096035;6134952;17961083;671571
2022;5;Salzburg;10531594;2994128;7537466;293522
2022;6;Steiermark;20679408;5582317;15097091;576347
2022;7;Tirol;9476252;3731418;5744834;264109
2022;8;Vorarlberg;7024753;1508340;5516413;195784
2022;9;Wien;61841676;54301874;7539802;1723564
2022;10;Österreich;183002443;90425521;92576922;5100386
2022;1;Burgenland;5141625;1619871;3521754;143300
2022;2;Kärnten;6541529;1481700;5059829;182316
2022;3;Niederösterreich;37682538;13082693;24599845;1050235
2022;4;Oberösterreich;24100420;6138099;17962321;671693
2022;5;Salzburg;10533244;2995309;7537935;293568
2022;6;Steiermark;20686065;5588379;15097686;576533
2022;7;Tirol;9478791;3733957;5744834;264179
2022;8;Vorarlberg;7025754;1508886;5516868;195812
2022;9;Wien;61896191;54355617;7540574;1725083
2022;10;Österreich;183086157;90504511;92581646;5102719
2022;1;Burgenland;5144173;1622284;3521889;143371
2022;2;Kärnten;6542587;1482646;5059941;182346
2022;3;Niederösterreich;37689625;13088930;24600695;1050432
2022;4;Oberösterreich;24104701;6141066;17963635;671812
2022;5;Salzburg;10534693;2996439;7538254;293608
2022;6;Steiermark;20688873;5590562;15098311;576611
2022;7;Tirol;9480154;3735320;5744834;264217
2022;8;Vorarlberg;7027056;1509535;5517521;195848
2022;9;Wien;61945915;54404596;7541319;1726469
2022;10;Österreich;183157777;90571378;92586399;5104715
2022;1;Burgenland;5146590;1624013;3522577;143438
2022;2;Kärnten;6549399;1484343;5065056;182536
2022;3;Niederösterreich;37699064;13095750;24603314;1050695
2022;4;Oberösterreich;24113354;6145140;17968214;672053
2022;5;Salzburg;10537215;2998322;7538893;293678
2022;6;Steiermark;20695501;5595463;15100038;576796
2022;7;Tirol;9484141;3739307;5744834;264329
2022;8;Vorarlberg;7029376;1510314;5519062;195913
2022;9;Wien;62067249;54525290;7541959;1729851
2022;10;Österreich;183321889;90717942;92603947;5109289
2022;1;Burgenland;5150596;1627756;3522840;143550
2022;2;Kärnten;6550765;1485373;5065392;182574
2022;3;Niederösterreich;37713121;13104442;24608679;1051087
2022;4;Oberösterreich;24121590;6148412;17973178;672283
2022;5;Salzburg;10539900;3000526;7539374;293753
2022;6;Steiermark;20717785;5602788;15114997;577417
2022;7;Tirol;9486944;3742110;5744834;264407
2022;8;Vorarlberg;7031841;1511318;5520523;195982
2022;9;Wien;62210138;54665322;7544816;1733833
2022;10;Österreich;183522680;90888047;92634633;5114885
2022;1;Burgenland;5155425;1632128;3523297;143685
2022;2;Kärnten;6552307;1486699;5065608;182617
2022;3;Niederösterreich;37720865;13110483;24610382;1051303
2022;4;Oberösterreich;24142540;6150812;17991728;672867
2022;5;Salzburg;10542022;3002227;7539795;293812
2022;6;Steiermark;20724431;5608175;15116256;577602
2022;7;Tirol;9489782;3744948;5744834;264486
2022;8;Vorarlberg;7033519;1512063;5521456;196028
2022;9;Wien;62321998;54774452;7547546;1736951
2022;10;Österreich;183682889;91021987;92660902;5119350
2022;1;Burgenland;5158426;1634876;3523550;143768
2022;2;Kärnten;6554271;1487668;5066603;182671
2022;3;Niederösterreich;37891034;13276960;24614074;1056045
2022;4;Oberösterreich;24148608;6155180;17993428;673036
2022;5;Salzburg;10544005;3003746;7540259;293868
2022;6;Steiermark;20732103;5614650;15117453;577816
2022;7;Tirol;9492210;3747376;5744834;264553
2022;8;Vorarlberg;7034953;1512818;5522135;196068
2022;9;Wien;62413688;54863389;7550299;1739506
2022;10;Österreich;183969298;91296663;92672635;5127333
2022;1;Burgenland;5163282;1637580;3525702;143904
2022;2;Kärnten;6555939;1488506;5067433;182718
2022;3;Niederösterreich;37900336;13284606;24615730;1056305
2022;4;Oberösterreich;24153034;6158173;17994861;673159
2022;5;Salzburg;10545726;3005042;7540684;293916
2022;6;Steiermark;20738195;5619685;15118510;577986
2022;7;Tirol;9494665;3749831;5744834;264622
2022;8;Vorarlberg;7036049;1513343;5522706;196099
2022;9;Wien;62482170;54929171;7552999;1741415
2022;10;Österreich;184069396;91385937;92683459;5130123
2022;1;Burgenland;5166014;1640150;3525864;143980
2022;2;Kärnten;6556614;1489181;5067433;182737
2022;3;Niederösterreich;37907448;13291438;24616010;1056503
2022;4;Oberösterreich;24156379;6160547;17995832;673253
2022;5;Salzburg;10547093;3006082;7541011;293954
2022;6;Steiermark;20743460;5624373;15119087;578132
2022;7;Tirol;9496823;3751989;5744834;264682
2022;8;Vorarlberg;7036823;1513889;5522934;196120
2022;9;Wien;62536438;54980758;7555680;1742927
2022;10;Österreich;184147092;91458407;92688685;5132288
2022;1;Burgenland;5168272;1642408;3525864;144043
2022;2;Kärnten;6557706;1490271;5067435;182767
2022;3;Niederösterreich;37912128;13295823;24616305;1056633
2022;4;Oberösterreich;24159465;6163246;17996219;673339
2022;5;Salzburg;10548254;3006905;7541349;293986
2022;6;Steiermark;20746627;5626957;15119670;578221
2022;7;Tirol;9498028;3753194;5744834;264716
2022;8;Vorarlberg;7037581;1514406;5523175;196142
2022;9;Wien;62587335;55028826;7558509;1744346
2022;10;Österreich;184215396;91522036;92693360;5134192
2022;1;Burgenland;5170213;1643949;3526264;144097
2022;2;Kärnten;6559444;1491661;5067783;182816
2022;3;Niederösterreich;37920800;13302931;24617869;1056875
2022;4;Oberösterreich;24167213;6167001;18000212;673554
2022;5;Salzburg;10550943;3008998;7541945;294061
2022;6;Steiermark;20753269;5632090;15121179;578406
2022;7;Tirol;9501411;3756577;5744834;264810
2022;8;Vorarlberg;7039046;1515105;5523941;196182
2022;9;Wien;62725843;55164511;7561332;1748206
2022;10;Österreich;184388182;91682823;92705359;5139007
2022;1;Burgenland;5175049;1648247;3526802;144232
2022;2;Kärnten;6565840;1492940;5072900;182994
2022;3;Niederösterreich;37931476;13312200;24619276;1057173
2022;4;Oberösterreich;24171661;6169337;18002324;673678
2022;5;Salzburg;10552718;3010411;7542307;294110
2022;6;Steiermark;20813389;5638476;15174913;580081
2022;7;Tirol;9504032;3759198;5744834;264883
2022;8;Vorarlberg;7040434;1515853;5524581;196221
2022;9;Wien;62862503;55299939;7562564;1752015
2022;10;Österreich;184617102;91846601;92770501;5145388
2022;1;Burgenland;5179199;1652089;3527110;144347
2022;2;Kärnten;6567277;1494177;5073100;183034
2022;3;Niederösterreich;37940328;13319649;24620679;1057419
2022;4;Oberösterreich;24188284;6171746;18016538;674142
2022;5;Salzburg;10554646;3012016;7542630;294164
2022;6;Steiermark;20829064;5644144;15184920;580518
2022;7;Tirol;9506505;3761671;5744834;264952
2022;8;Vorarlberg;7041764;1516537;5525227;196258
2022;9;Wien;62958433;55394651;7563782;1754689
2022;10;Österreich;184765500;91966680;92798820;5149523
2022;1;Burgenland;5182207;1654736;3527471;144431
2022;2;Kärnten;6568225;1494896;5073329;183060
2022;3;Niederösterreich;37947266;13325154;24622112;1057613
2022;4;Oberösterreich;24196199;6175121;18021078;674362
2022;5;Salzburg;10556448;3013445;7543003;294214
2022;6;Steiermark;20835296;5649237;15186059;580692
2022;7;Tirol;9508622;3763788;5744834;265011
2022;8;Vorarlberg;7041764;1516537;5525227;196258
2022;9;Wien;63038671;55473686;7564985;1756925
2022;10;Österreich;184874698;92066600;92808098;5152567
2022;1;Burgenland;5185492;1657373;3528119;144523
2022;2;Kärnten;6568878;1495476;5073402;183079
2022;3;Niederösterreich;37954720;13331283;24623437;1057820
2022;4;Oberösterreich;24200272;6177875;18022397;674476
2022;5;Salzburg;10557960;3014626;7543334;294257
2022;6;Steiermark;20841561;5654625;15186936;580867
2022;7;Tirol;9510807;3765973;5744834;265072
2022;8;Vorarlberg;7044180;1517719;5526461;196325
2022;9;Wien;63100725;55534486;7566239;1758654
2022;10;Österreich;184964595;92149436;92815159;5155072
2022;1;Burgenland;5188111;1659787;3528324;144596
2022;2;Kärnten;6569518;1496099;5073419;183096
2022;3;Niederösterreich;37960787;13337155;24623632;1057990
2022;4;Oberösterreich;24203419;6180155;18023264;674564
2022;5;Salzburg;10559380;3015761;7543619;294296
2022;6;Steiermark;20846317;5658843;15187474;580999
2022;7;Tirol;9512700;3767866;5744834;265125
2022;8;Vorarlberg;7044909;1518230;5526679;196346
2022;9;Wien;63149764;55582349;7567415;1760021
2022;10;Österreich;185034905;92216245;92818660;5157032
2022;1;Burgenland;5190121;1661653;3528468;144652
2022;2;Kärnten;6570442;1496924;5073518;183122
2022;3;Niederösterreich;38344154;13504462;24839692;1068674
2022;4;Oberösterreich;24206532;6182271;18024261;674650
2022;5;Salzburg;10560475;3016592;7543883;294327
2022;6;Steiermark;20849544;5661580;15187964;581089
2022;7;Tirol;9513819;3768985;5744834;265156
2022;8;Vorarlberg;7045600;1518694;5526906;196365
2022;9;Wien;63189351;55620623;7568728;1761124
2022;10;Österreich;185470038;92431784;93038254;5169159
2022;1;Burgenland;5192374;1663442;3528932;144715
2022;2;Kärnten;6574650;1498404;5076246;183239
2022;3;Niederösterreich;38354002;13511652;24842350;1068949
2022;4;Oberösterreich;24215561;6185368;18030193;674902
2022;5;Salzburg;10562432;3018145;7544287;294381
2022;6;Steiermark;20854185;5664874;15189311;581218
2022;7;Tirol;9516789;3771955;5744834;265239
2022;8;Vorarlberg;7047140;1519442;5527698;196408
2022;9;Wien;63308794;55738652;7570142;1764453
2022;10;Österreich;185625927;92571934;93053993;5173504
2022;1;Burgenland;5196120;1666741;3529379;144819
2022;2;Kärnten;6575600;1499335;5076265;183266
2022;3;Niederösterreich;38403541;13554303;24849238;1070329
2022;4;Oberösterreich;24220567;6187418;18033149;675041
2022;5;Salzburg;10564088;3019471;7544617;294427
2022;6;Steiermark;20875099;5670995;15204104;581801
2022;7;Tirol;9519224;3774390;5744834;265306
2022;8;Vorarlberg;7048288;1520065;5528223;196440
2022;9;Wien;63448736;55878113;7570623;1768354
2022;10;Österreich;185851263;92770831;93080432;5179784
2022;1;Burgenland;5199972;1670070;3529902;144926
2022;2;Kärnten;6579770;1500364;5079406;183382
2022;3;Niederösterreich;38411450;13560412;24851038;1070550
2022;4;Oberösterreich;24236916;6189925;18046991;675497
2022;5;Salzburg;10565636;3020735;7544901;294471
2022;6;Steiermark;20880712;5675494;15205218;581958
2022;7;Tirol;9521250;3776416;5744834;265363
2022;8;Vorarlberg;7049392;1520646;5528746;196471
2022;9;Wien;63542023;55970217;7571806;1770954
2022;10;Österreich;185987121;92884279;93102842;5183571
2022;1;Burgenland;5202841;1672440;3530401;145006
2022;2;Kärnten;6580637;1500980;5079657;183406
2022;3;Niederösterreich;38547864;13694979;24852885;1074352
2022;4;Oberösterreich;24241658;6193265;18048393;675629
2022;5;Salzburg;10566774;3021540;7545234;294502
2022;6;Steiermark;20885992;5680191;15205801;582105
2022;7;Tirol;9523073;3778239;5744834;265414
2022;8;Vorarlberg;7050289;1521016;5529273;196496
2022;9;Wien;63615765;56042818;7572947;1773009
2022;10;Österreich;186214893;93105468;93109425;5189919
2022;1;Burgenland;5208379;1674558;3533821;145161
2022;2;Kärnten;6581244;1501550;5079694;183423
2022;3;Niederösterreich;38585230;13701055;24884175;1075393
2022;4;Oberösterreich;24245099;6195466;18049633;675725
2022;5;Salzburg;10568489;3022969;7545520;294550
2022;6;Steiermark;20890257;5683914;15206343;582224
2022;7;Tirol;9524823;3779989;5744834;265462
2022;8;Vorarlberg;7051256;1521588;5529668;196523
2022;9;Wien;63672751;56098679;7574072;1774597
2022;10;Österreich;186327528;93179768;93147760;5193058
2022;1;Burgenland;5210835;1676873;3533962;145229
2022;2;Kärnten;6581746;1502041;5079705;183437
2022;3;Niederösterreich;38590429;13705899;24884530;1075538
2022;4;Oberösterreich;24246421;6195995;18050426;675762
2022;5;Salzburg;10569411;3023642;7545769;294576
2022;6;Steiermark;20893735;5687216;15206519;582321
2022;7;Tirol;9526239;3781405;5744834;265502
2022;8;Vorarlberg;7051703;1521789;5529914;196535
2022;9;Wien;63710826;56135582;7575244;1775658
2022;10;Österreich;186381345;93230442;93150903;5194558
2022;1;Burgenland;5212582;1678476;3534106;145278
2022;2;Kärnten;6582324;1502468;5079856;183453
2022;3;Niederösterreich;38594115;13709334;24884781;1075641
2022;4;Oberösterreich;24250938;6199529;18051409;675888
2022;5;Salzburg;10570466;3024508;7545958;294605
2022;6;Steiermark;20896202;5689638;15206564;582389
2022;7;Tirol;9527066;3782232;5744834;265525
2022;8;Vorarlberg;7052326;1522147;5530179;196552
2022;9;Wien;63735052;56158454;7576598;1776334
2022;10;Österreich;186421071;93266786;93154285;5195665
2022;1;Burgenland;5214864;1680018;3534846;145341
2022;2;Kärnten;6585890;1504047;5081843;183553
2022;3;Niederösterreich;38735221;13715392;25019829;1079573
2022;4;Oberösterreich;24253754;6201938;18051816;675966
2022;5;Salzburg;10572258;3025926;7546332;294655
2022;6;Steiermark;20900880;5693385;15207495;582520
2022;7;Tirol;9529433;3784599;5744834;265591
2022;8;Vorarlberg;7053622;1522752;5530870;196589
2022;9;Wien;63865492;56287659;7577833;1779969
2022;10;Österreich;186711414;93415716;93295698;5203757
2022;1;Burgenland;5302462;1767136;3535326;147783
2022;2;Kärnten;6585890;1504047;5081843;183553
2022;3;Niederösterreich;38746059;13721116;25024943;1079876
2022;4;Oberösterreich;24260169;6203690;18056479;676145
2022;5;Salzburg;10573798;3027179;7546619;294698
2022;6;Steiermark;20919353;5698894;15220459;583035
2022;7;Tirol;9531349;3786515;5744834;265644
2022;8;Vorarlberg;7054630;1523248;5531382;196617
2022;9;Wien;63994602;56415581;7579021;1783567
2022;10;Österreich;186968312;93647406;93320906;5210917
2022;1;Burgenland;5305790;1770078;3535712;147875
2022;2;Kärnten;6585890;1504047;5081843;183553
2022;3;Niederösterreich;38912628;13862485;25050143;1084518
2022;4;Oberösterreich;24263486;6205506;18057980;676238
2022;5;Salzburg;10575358;3028358;7547000;294741
2022;6;Steiermark;20923470;5702351;15221119;583149
2022;7;Tirol;9533172;3788338;5744834;265695
2022;8;Vorarlberg;7055636;1523737;5531899;196645
2022;9;Wien;64072055;56491226;7580829;1785726
2022;10;Österreich;187227485;93876126;93351359;5218140
2022;1;Burgenland;5309197;1773321;3535876;147970
2022;2;Kärnten;6585890;1504047;5081843;183553
2022;3;Niederösterreich;38918386;13867336;25051050;1084678
2022;4;Oberösterreich;24266552;6207726;18058826;676323
2022;5;Salzburg;10576242;3028994;7547248;294766
2022;6;Steiermark;20927593;5705647;15221946;583264
2022;7;Tirol;9533725;3788891;5744834;265711
2022;8;Vorarlberg;7056154;1524024;5532130;196659
2022;9;Wien;64111304;56528592;7582712;1786820
2022;10;Österreich;187285043;93928578;93356465;5219745
2022;1;Burgenland;5310859;1773847;3537012;148017
2022;2;Kärnten;6585890;1504047;5081843;183553
2022;3;Niederösterreich;38923291;13871299;25051992;1084815
2022;4;Oberösterreich;24269643;6209817;18059826;676409
2022;5;Salzburg;10577284;3029807;7547477;294795
2022;6;Steiermark;20929794;5707084;15222710;583326
2022;7;Tirol;9535056;3790222;5744834;265748
2022;8;Vorarlberg;7056864;1524419;5532445;196679
2022;9;Wien;64143572;56559082;7584490;1787719
2022;10;Österreich;187332253;93969624;93362629;5221060
2022;1;Burgenland;5313708;1776657;3537051;148096
2022;2;Kärnten;6585890;1504047;5081843;183553
2022;3;Niederösterreich;38928322;13876168;25052154;1084955
2022;4;Oberösterreich;24271774;6211356;18060418;676469
2022;5;Salzburg;10578287;3030631;7547656;294823
2022;6;Steiermark;20932696;5709781;15222915;583407
2022;7;Tirol;9536264;3791430;5744834;265781
2022;8;Vorarlberg;7057234;1524602;5532632;196689
2022;9;Wien;64187822;56601520;7586302;1788952
2022;10;Österreich;187391997;94026192;93365805;5222726
2022;1;Burgenland;5315357;1778177;3537180;148142
2022;2;Kärnten;6585890;1504047;5081843;183553
2022;3;Niederösterreich;38932755;13879679;25053076;1085079
2022;4;Oberösterreich;24273415;6212721;18060694;676514
2022;5;Salzburg;10579028;3031190;7547838;294844
2022;6;Steiermark;20935246;5711757;15223489;583478
2022;7;Tirol;9537000;3792166;5744834;265802
2022;8;Vorarlberg;7057754;1524894;5532860;196704
2022;9;Wien;64220837;56632516;7588321;1789873
2022;10;Österreich;187437282;94067147;93370135;5223988
2022;1;Burgenland;5317090;1779453;3537637;148190
2022;2;Kärnten;6591553;1507950;5083603;183710
2022;3;Niederösterreich;38936306;13882424;25053882;1085178
2022;4;Oberösterreich;24278968;6214710;18064258;676669
2022;5;Salzburg;10580601;3032431;7548170;294888
2022;6;Steiermark;20940744;5715755;15224989;583631
2022;7;Tirol;9538747;3793913;5744834;265851
2022;8;Vorarlberg;7058910;1525316;5533594;196736
2022;9;Wien;64254942;56664637;7590305;1790823
2022;10;Österreich;187497861;94116589;93381272;5225676
2022;1;Burgenland;5321206;1783113;3538093;148305
2022;2;Kärnten;6593081;1508934;5084147;183753
2022;3;Niederösterreich;38945221;13887286;25057935;1085426
2022;4;Oberösterreich;24288800;6216917;18071883;676943
2022;5;Salzburg;10582478;3034041;7548437;294940
2022;6;Steiermark;20955641;5721117;15234524;584046
2022;7;Tirol;9541011;3796177;5744834;265914
2022;8;Vorarlberg;7059869;1525849;5534020;196763
2022;9;Wien;64459599;56867408;7592191;1796527
2022;10;Österreich;187746906;94340842;93406064;5232617
2022;1;Burgenland;5324370;1786076;3538294;148393
2022;2;Kärnten;6594793;1510436;5084357;183801
2022;3;Niederösterreich;38979722;13919786;25059936;1086388
2022;4;Oberösterreich;24309450;6218639;18090811;677519
2022;5;Salzburg;10583932;3035092;7548840;294980
2022;6;Steiermark;20960671;5725159;15235512;584186
2022;7;Tirol;9542568;3797734;5744834;265957
2022;8;Vorarlberg;7060765;1526313;5534452;196788
2022;9;Wien;64544298;56951132;7593166;1798888
2022;10;Österreich;187900569;94470367;93430202;5236900
2022;1;Burgenland;5242424;1703779;3538645;146109
2022;2;Kärnten;6597659;1510973;5086686;183881
2022;3;Niederösterreich;39136445;14059635;25076810;1090756
2022;4;Oberösterreich;24313469;6221244;18092225;677631
2022;5;Salzburg;10585317;3036202;7549115;295019
2022;6;Steiermark;20965433;5729286;15236147;584319
2022;7;Tirol;9543759;3798925;5744834;265990
2022;8;Vorarlberg;7061685;1526743;5534942;196813
2022;9;Wien;64598585;57004439;7594146;1800401
2022;10;Österreich;188044776;94591226;93453550;5240919
2022;1;Burgenland;5245004;1705915;3539089;146181
2022;2;Kärnten;6598132;1511391;5086741;183894
2022;3;Niederösterreich;39142359;14064407;25077952;1090921
2022;4;Oberösterreich;24317223;6224012;18093211;677735
2022;5;Salzburg;10586263;3036906;7549357;295045
2022;6;Steiermark;20969551;5732306;15237245;584434
2022;7;Tirol;9545012;3800178;5744834;266025
2022;8;Vorarlberg;7062427;1527171;5535256;196834
2022;9;Wien;64641230;57046041;7595189;1801589
2022;10;Österreich;188107201;94648327;93458874;5242659
2022;1;Burgenland;5247275;1707957;3539318;146245
2022;2;Kärnten;6598550;1511800;5086750;183905
2022;3;Niederösterreich;39146447;14068315;25078132;1091035
2022;4;Oberösterreich;24319358;6225556;18093802;677795
2022;5;Salzburg;10587230;3037773;7549457;295072
2022;6;Steiermark;20972341;5734774;15237567;584512
2022;7;Tirol;9546079;3801245;5744834;266055
2022;8;Vorarlberg;7062810;1527393;5535417;196845
2022;9;Wien;64668815;57072661;7596154;1802358
2022;10;Österreich;188148905;94687474;93461431;5243821
2022;1;Burgenland;5248794;1709442;3539352;146287
2022;2;Kärnten;6598665;1511914;5086751;183909
2022;3;Niederösterreich;39149837;14071646;25078191;1091129
2022;4;Oberösterreich;24320929;6226556;18094373;677839
2022;5;Salzburg;10587858;3038292;7549566;295090
2022;6;Steiermark;20973892;5736165;15237727;584555
2022;7;Tirol;9546772;3801938;5744834;266074
2022;8;Vorarlberg;7063367;1527787;5535580;196860
2022;9;Wien;64679613;57082401;7597212;1802659
2022;10;Österreich;188169727;94706141;93463586;5244401
2022;1;Burgenland;5250117;1710669;3539448;146324
2022;2;Kärnten;6599419;1512588;5086831;183930
2022;3;Niederösterreich;39152585;14074165;25078420;1091206
2022;4;Oberösterreich;24324780;6228352;18096428;677946
2022;5;Salzburg;10588702;3038964;7549738;295113
2022;6;Steiermark;20974847;5736720;15238127;584581
2022;7;Tirol;9547746;3802912;5744834;266101
2022;8;Vorarlberg;7063930;1528083;5535847;196876
2022;9;Wien;64710107;57111872;7598235;1803509
2022;10;Österreich;188212233;94744325;93467908;5245586
2022;1;Burgenland;5251725;1711915;3539810;146369
2022;2;Kärnten;6602190;1513741;5088449;184007
2022;3;Niederösterreich;39160230;14078527;25081703;1091419
2022;4;Oberösterreich;24355347;6230321;18125026;678798
2022;5;Salzburg;10590483;3040526;7549957;295163
2022;6;Steiermark;20987249;5739537;15247712;584927
2022;7;Tirol;9549920;3805086;5744834;266162
2022;8;Vorarlberg;7065362;1528872;5536490;196916
2022;9;Wien;64752690;57153418;7599272;1804696
2022;10;Österreich;188315196;94801943;93513253;5248456
2022;1;Burgenland;5256002;1715565;3540437;146488
2022;2;Kärnten;6603326;1514725;5088601;184039
2022;3;Niederösterreich;39285543;14082298;25203245;1094911
2022;4;Oberösterreich;24367054;6231765;18135289;679124
2022;5;Salzburg;10592076;3041828;7550248;295207
2022;6;Steiermark;20995202;5744927;15250275;585149
2022;7;Tirol;9551738;3806904;5744834;266213
2022;8;Vorarlberg;7066382;1529393;5536989;196944
2022;9;Wien;64834843;57234172;7600671;1806985
2022;10;Österreich;188552166;94901577;93650589;5255060
2022;1;Burgenland;5263305;1718030;3545275;146691
2022;2;Kärnten;6603908;1515304;5088604;184055
2022;3;Niederösterreich;39290186;14085991;25204195;1095041
2022;4;Oberösterreich;24370320;6233486;18136834;679215
2022;5;Salzburg;10593536;3043013;7550523;295248
2022;6;Steiermark;21005744;5748743;15257001;585442
2022;7;Tirol;9553323;3808489;5744834;266257
2022;8;Vorarlberg;7067439;1529994;5537445;196974
2022;9;Wien;64888225;57286176;7602049;1808473
2022;10;Österreich;188635986;94969226;93666760;5257396
2022;1;Burgenland;5265883;1720158;3545725;146763
2022;2;Kärnten;6604838;1515706;5089132;184081
2022;3;Niederösterreich;39295042;14089925;25205117;1095176
2022;4;Oberösterreich;24374239;6236112;18138127;679324
2022;5;Salzburg;10594779;3044043;7550736;295283
2022;6;Steiermark;21009518;5751662;15257856;585548
2022;7;Tirol;9554996;3810162;5744834;266303
2022;8;Vorarlberg;7068530;1530615;5537915;197004
2022;9;Wien;64925129;57321731;7603398;1809502
2022;10;Österreich;188692954;95020114;93672840;5258984
2022;1;Burgenland;5268347;1722428;3545919;146832
2022;2;Kärnten;6605217;1516083;5089134;184091
2022;3;Niederösterreich;39300249;14094320;25205929;1095321
2022;4;Oberösterreich;24376737;6237959;18138778;679394
2022;5;Salzburg;10595713;3044827;7550886;295309
2022;6;Steiermark;21012921;5754708;15258213;585643
2022;7;Tirol;9556291;3811457;5744834;266339
2022;8;Vorarlberg;7068968;1530884;5538084;197016
2022;9;Wien;64940717;57336162;7604555;1809936
2022;10;Österreich;188725160;95048828;93676332;5259882
2022;1;Burgenland;5270135;1724120;3546015;146882
2022;2;Kärnten;6605995;1516748;5089247;184113
2022;3;Niederösterreich;39302952;14096850;25206102;1095396
2022;4;Oberösterreich;24379381;6239646;18139735;679468
2022;5;Salzburg;10596640;3045604;7551036;295335
2022;6;Steiermark;21014780;5756267;15258513;585694
2022;7;Tirol;9557187;3812353;5744834;266364
2022;8;Vorarlberg;7069647;1531399;5538248;197035
2022;9;Wien;64995895;57389991;7605904;1811474
2022;10;Österreich;188792612;95112978;93679634;5261761
2022;1;Burgenland;5274729;1725608;3549121;147010
2022;2;Kärnten;6608915;1517924;5090991;184194
2022;3;Niederösterreich;39324573;14100754;25223819;1095999
2022;4;Oberösterreich;24383866;6242011;18141855;679593
2022;5;Salzburg;10604554;3047058;7557496;295555
2022;6;Steiermark;21018855;5759079;15259776;585808
2022;7;Tirol;9559661;3814827;5744834;266433
2022;8;Vorarlberg;7071270;1532324;5538946;197080
2022;9;Wien;65057831;57450325;7607506;1813200
2022;10;Österreich;188904254;95189910;93714344;5264873
2022;1;Burgenland;5278302;1728940;3549362;147109
2022;2;Kärnten;6610302;1518842;5091460;184233
2022;3;Niederösterreich;39420898;14130738;25290160;1098684
2022;4;Oberösterreich;24392425;6243918;18148507;679831
2022;5;Salzburg;10606122;3048366;7557756;295599
2022;6;Steiermark;21035534;5763912;15271622;586273
2022;7;Tirol;9561642;3816808;5744834;266489
2022;8;Vorarlberg;7072473;1533016;5539457;197114
2022;9;Wien;65121369;57512522;7608847;1814971
2022;10;Österreich;189099067;95297062;93802005;5270303
2022;1;Burgenland;5280940;1731452;3549488;147183
2022;2;Kärnten;6611636;1519421;5092215;184270
2022;3;Niederösterreich;39425468;14134571;25290897;1098811
2022;4;Oberösterreich;24407755;6246078;18161677;680259
2022;5;Salzburg;10607705;3049685;7558020;295643
2022;6;Steiermark;21040155;5767639;15272516;586402
2022;7;Tirol;9563985;3819151;5744834;266554
2022;8;Vorarlberg;7073819;1533862;5539957;197152
2022;9;Wien;65176802;57567601;7609201;1816516
2022;10;Österreich;189188265;95369460;93818805;5272789
2022;1;Burgenland;5283636;1734008;3549628;147258
2022;2;Kärnten;6612244;1520029;5092215;184287
2022;3;Niederösterreich;39442216;14137845;25304371;1099278
2022;4;Oberösterreich;24409800;6248078;18161722;680316
2022;5;Salzburg;10608829;3050652;7558177;295674
2022;6;Steiermark;21043361;5770597;15272764;586491
2022;7;Tirol;9564862;3820028;5744834;266578
2022;8;Vorarlberg;7074366;1534181;5540185;197167
2022;9;Wien;65210060;57600527;7609533;1817443
2022;10;Österreich;189249374;95415945;93833429;5274492
2022;1;Burgenland;5285742;1735412;3550330;147317
2022;2;Kärnten;6612762;1520547;5092215;184302
2022;3;Niederösterreich;39446879;14141821;25305058;1099408
2022;4;Oberösterreich;24414251;6250574;18163677;680440
2022;5;Salzburg;10610246;3051878;7558368;295714
2022;6;Steiermark;21045711;5772281;15273430;586556
2022;7;Tirol;9567042;3822208;5744834;266639
2022;8;Vorarlberg;7075576;1535006;5540570;197200
2022;9;Wien;65249884;57639925;7609959;1818553
2022;10;Österreich;189308093;95469652;93838441;5276128
2022;1;Burgenland;5288629;1738192;3550437;147397
2022;2;Kärnten;6613243;1521028;5092215;184315
2022;3;Niederösterreich;39450313;14145118;25305195;1099503
2022;4;Oberösterreich;24416271;6251986;18164285;680496
2022;5;Salzburg;10611448;3052956;7558492;295747
2022;6;Steiermark;21050141;5776398;15273743;586680
2022;7;Tirol;9568880;3824046;5744834;266690
2022;8;Vorarlberg;7076300;1535533;5540767;197221
2022;9;Wien;65284005;57673681;7610324;1819504
2022;10;Österreich;189359230;95518938;93840292;5277553
2022;1;Burgenland;5290643;1740168;3550475;147453
2022;2;Kärnten;6614122;1521822;5092300;184339
2022;3;Niederösterreich;39453683;14148333;25305350;1099597
2022;4;Oberösterreich;24418635;6253394;18165241;680562
2022;5;Salzburg;10612649;3054029;7558620;295781
2022;6;Steiermark;21052993;5778931;15274062;586759
2022;7;Tirol;9570280;3825446;5744834;266729
2022;8;Vorarlberg;7077123;1536144;5540979;197244
2022;9;Wien;65322954;57712163;7610791;1820589
2022;10;Österreich;189413082;95570430;93842652;5279054
2022;1;Burgenland;5293290;1742258;3551032;147527
2022;2;Kärnten;6615722;1523055;5092667;184384
2022;3;Niederösterreich;39459006;14152291;25306715;1099746
2022;4;Oberösterreich;24499942;6256073;18243869;682828
2022;5;Salzburg;10622000;3056141;7565859;296041
2022;6;Steiermark;21057021;5781629;15275392;586872
2022;7;Tirol;9573558;3828724;5744834;266821
2022;8;Vorarlberg;7079193;1537508;5541685;197301
2022;9;Wien;65388337;57777053;7611284;1822412
2022;10;Österreich;189588069;95654732;93933337;5283931
2022;1;Burgenland;5296934;1745725;3551209;147629
2022;2;Kärnten;6617326;1524024;5093302;184429
2022;3;Niederösterreich;39467754;14157805;25309949;1099990
2022;4;Oberösterreich;24504374;6258539;18245835;682951
2022;5;Salzburg;10623733;3057581;7566152;296090
2022;6;Steiermark;21065954;5789572;15276382;587121
2022;7;Tirol;9576139;3831305;5744834;266893
2022;8;Vorarlberg;7080581;1538448;5542133;197340
2022;9;Wien;65461265;57849502;7611763;1824444
2022;10;Österreich;189694060;95752501;93941559;5286885
2022;1;Burgenland;5300705;1748542;3552163;147734
2022;2;Kärnten;6618612;1524860;5093752;184465
2022;3;Niederösterreich;39472851;14161998;25310853;1100132
2022;4;Oberösterreich;24517486;6260945;18256541;683317
2022;5;Salzburg;10625599;3059193;7566406;296142
2022;6;Steiermark;21072143;5794743;15277400;587293
2022;7;Tirol;9578866;3834032;5744834;266969
2022;8;Vorarlberg;7082043;1539397;5542646;197381
2022;9;Wien;65523414;57911175;7612239;1826176
2022;10;Österreich;189791719;95834885;93956834;5289607
2022;1;Burgenland;5303122;1750435;3552687;147801
2022;2;Kärnten;6622879;1525891;5096988;184584
2022;3;Niederösterreich;39488037;14165585;25322452;1100555
2022;4;Oberösterreich;24522465;6264271;18258194;683456
2022;5;Salzburg;10627745;3061011;7566734;296202
2022;6;Steiermark;21078943;5800507;15278436;587483
2022;7;Tirol;9581314;3836480;5744834;267037
2022;8;Vorarlberg;7083273;1540130;5543143;197415
2022;9;Wien;65586573;57973951;7612622;1827936
2022;10;Österreich;189894351;95918261;93976090;5292468
2022;1;Burgenland;5306898;1753408;3553490;147906
2022;2;Kärnten;6623538;1526543;5096995;184602
2022;3;Niederösterreich;39495284;14171953;25323331;1100757
2022;4;Oberösterreich;24526831;6267374;18259457;683577
2022;5;Salzburg;10629419;3062431;7566988;296248
2022;6;Steiermark;21084645;5805271;15279374;587641
2022;7;Tirol;9583637;3838803;5744834;267102
2022;8;Vorarlberg;7084660;1541137;5543523;197454
2022;9;Wien;65649802;58036721;7613081;1829699
2022;10;Österreich;189984714;96003641;93981073;5294986
2022;1;Burgenland;5309711;1756069;3553642;147985
2022;2;Kärnten;6623864;1526864;5097000;184611
2022;3;Niederösterreich;39500072;14176599;25323473;1100890
2022;4;Oberösterreich;24530160;6269926;18260234;683670
2022;5;Salzburg;10630853;3063716;7567137;296288
2022;6;Steiermark;21089190;5809436;15279754;587768
2022;7;Tirol;9585834;3841000;5744834;267163
2022;8;Vorarlberg;7085178;1541491;5543687;197468
2022;9;Wien;65693636;58080121;7613515;1830920
2022;10;Österreich;190048498;96065222;93983276;5296764
2022;1;Burgenland;5312072;1758381;3553691;148051
2022;2;Kärnten;6624795;1527769;5097026;184637
2022;3;Niederösterreich;39504394;14180714;25323680;1101011
2022;4;Oberösterreich;24533137;6271857;18261280;683753
2022;5;Salzburg;10632241;3064952;7567289;296327
2022;6;Steiermark;21092838;5812726;15280112;587870
2022;7;Tirol;9587477;3842643;5744834;267209
2022;8;Vorarlberg;7086477;1542570;5543907;197504
2022;9;Wien;65735292;58121290;7614002;1832081
2022;10;Österreich;190108723;96122902;93985821;5298442
2022;1;Burgenland;5317076;1761249;3555827;148190
2022;2;Kärnten;6628795;1529420;5099375;184748
2022;3;Niederösterreich;39513740;14186270;25327470;1101271
2022;4;Oberösterreich;24539832;6275343;18264489;683940
2022;5;Salzburg;10640703;3067015;7573688;296563
2022;6;Steiermark;21098196;5816694;15281502;588019
2022;7;Tirol;9590745;3845911;5744834;267300
2022;8;Vorarlberg;7088523;1543803;5544720;197561
2022;9;Wien;65808360;58193874;7614486;1834118
2022;10;Österreich;190225970;96219579;94006391;5301710
2022;1;Burgenland;5321604;1765287;3556317;148316
2022;2;Kärnten;6629884;1530509;5099375;184779
2022;3;Niederösterreich;39558194;14228023;25330171;1102510
2022;4;Oberösterreich;24544528;6278183;18266345;684070
2022;5;Salzburg;10642798;3068863;7573935;296621
2022;6;Steiermark;21128634;5825678;15302956;588867
2022;7;Tirol;9594203;3849369;5744834;267396
2022;8;Vorarlberg;7090629;1545187;5545442;197620
2022;9;Wien;65884970;58269979;7614991;1836253
2022;10;Österreich;190395444;96361078;94034366;5306433
2022;1;Burgenland;5325363;1768549;3556814;148421
2022;2;Kärnten;6632493;1531465;5101028;184851
2022;3;Niederösterreich;39564628;14232961;25331667;1102690
2022;4;Oberösterreich;24561362;6279983;18281379;684540
2022;5;Salzburg;10644930;3070721;7574209;296680
2022;6;Steiermark;21136292;5832128;15304164;589081
2022;7;Tirol;9597438;3852604;5744834;267486
2022;8;Vorarlberg;7092138;1546127;5546011;197662
2022;9;Wien;65962358;58346914;7615444;1838410
2022;10;Österreich;190517002;96461452;94055550;5309821
2022;1;Burgenland;5328512;1771574;3556938;148509
2022;2;Kärnten;6633304;1532273;5101031;184874
2022;3;Niederösterreich;39570655;14237098;25333557;1102858
2022;4;Oberösterreich;24567208;6284191;18283017;684703
2022;5;Salzburg;10647174;3072699;7574475;296743
2022;6;Steiermark;21143591;5838385;15305206;589284
2022;7;Tirol;9600356;3855522;5744834;267568
2022;8;Vorarlberg;7093824;1547119;5546705;197709
2022;9;Wien;66025576;58409690;7615886;1840172
2022;10;Österreich;190610200;96548551;94061649;5312419
2022;1;Burgenland;5333396;1774495;3558901;148645
2022;2;Kärnten;6633948;1532914;5101034;184892
2022;3;Niederösterreich;39578255;14243232;25335023;1103069
2022;4;Oberösterreich;24571705;6287265;18284440;684828
2022;5;Salzburg;10649058;3074237;7574821;296796
2022;6;Steiermark;21148521;5842371;15306150;589422
2022;7;Tirol;9603286;3858452;5744834;267649
2022;8;Vorarlberg;7095473;1548296;5547177;197755
2022;9;Wien;66088229;58471927;7616302;1841918
2022;10;Österreich;190701871;96633189;94068682;5314974
2022;1;Burgenland;5336560;1777555;3559005;148733
2022;2;Kärnten;6634700;1533665;5101035;184913
2022;3;Niederösterreich;39584115;14248932;25335183;1103233
2022;4;Oberösterreich;24575520;6290340;18285180;684934
2022;5;Salzburg;10650422;3075419;7575003;296834
2022;6;Steiermark;21154416;5847874;15306542;589586
2022;7;Tirol;9605891;3861057;5744834;267722
2022;8;Vorarlberg;7096687;1549309;5547378;197789
2022;9;Wien;66130812;58514146;7616666;1843105
2022;10;Österreich;190769123;96698297;94070826;5316848
2022;1;Burgenland;5339237;1780084;3559153;148808
2022;2;Kärnten;6635942;1534238;5101704;184948
2022;3;Niederösterreich;39589153;14253796;25335357;1103373
2022;4;Oberösterreich;24578812;6292594;18286218;685026
2022;5;Salzburg;10652012;3076858;7575154;296878
2022;6;Steiermark;21158180;5851249;15306931;589691
2022;7;Tirol;9607640;3862806;5744834;267771
2022;8;Vorarlberg;7097834;1550229;5547605;197821
2022;9;Wien;66174532;58557360;7617172;1844323
2022;10;Österreich;190833342;96759214;94074128;5318638
2022;1;Burgenland;5341873;1782385;3559488;148881
2022;2;Kärnten;6640313;1536685;5103628;185069
2022;3;Niederösterreich;39612887;14260349;25352538;1104035
2022;4;Oberösterreich;24593789;6295923;18297866;685443
2022;5;Salzburg;10661429;3078629;7582800;297140
2022;6;Steiermark;21164595;5856138;15308457;589870
2022;7;Tirol;9611842;3867008;5744834;267888
2022;8;Vorarlberg;7099139;1550600;5548539;197857
2022;9;Wien;66244356;58626697;7617659;1846269
2022;10;Österreich;190970223;96854414;94115809;5322453
2022;1;Burgenland;5346530;1786521;3560009;149011
2022;2;Kärnten;6642464;1537761;5104703;185129
2022;3;Niederösterreich;39621526;14266707;25354819;1104275
2022;4;Oberösterreich;24600352;6299046;18301306;685626
2022;5;Salzburg;10663945;3080871;7583074;297210
2022;6;Steiermark;21184532;5863600;15320932;590425
2022;7;Tirol;9615321;3870487;5744834;267985
2022;8;Vorarlberg;7101443;1552242;5549201;197921
2022;9;Wien;66306135;58688046;7618089;1847991
2022;10;Österreich;191082248;96945281;94136967;5325575
2022;1;Burgenland;5349942;1789702;3560240;149106
2022;2;Kärnten;6645081;1539278;5105803;185202
2022;3;Niederösterreich;39633407;14273402;25360005;1104606
2022;4;Oberösterreich;24615100;6302015;18313085;686037
2022;5;Salzburg;10666284;3082933;7583351;297276
2022;6;Steiermark;21192733;5870703;15322030;590654
2022;7;Tirol;9618852;3874018;5744834;268083
2022;8;Vorarlberg;7103562;1553651;5549911;197980
2022;9;Wien;66339481;58720929;7618552;1848920
2022;10;Österreich;191164442;97006631;94157811;5327866
2022;1;Burgenland;5352851;1792433;3560418;149187
2022;2;Kärnten;6646445;1540642;5105803;185240
2022;3;Niederösterreich;39639698;14278436;25361262;1104782
2022;4;Oberösterreich;24621022;6306086;18314936;686202
2022;5;Salzburg;10668678;3084978;7583700;297342
2022;6;Steiermark;21206691;5876842;15329849;591043
2022;7;Tirol;9621798;3876964;5744834;268165
2022;8;Vorarlberg;7105188;1554770;5550418;198026
2022;9;Wien;66406390;58787343;7619047;1850785
2022;10;Österreich;191268761;97098494;94170267;5330773
2022;1;Burgenland;5359613;1796533;3563080;149376
2022;2;Kärnten;6647323;1541520;5105803;185265
2022;3;Niederösterreich;39647416;14284911;25362505;1104997
2022;4;Oberösterreich;24626213;6309886;18316327;686347
2022;5;Salzburg;10670428;3086507;7583921;297391
2022;6;Steiermark;21213395;5882623;15330772;591230
2022;7;Tirol;9624848;3880014;5744834;268250
2022;8;Vorarlberg;7107019;1556141;5550878;198077
2022;9;Wien;66475836;58856356;7619480;1852721
2022;10;Österreich;191372091;97194491;94177600;5333653
2022;1;Burgenland;5362971;1799751;3563220;149469
2022;2;Kärnten;6648076;1542270;5105806;185286
2022;3;Niederösterreich;39652954;14290270;25362684;1105151
2022;4;Oberösterreich;24629848;6312692;18317156;686448
2022;5;Salzburg;10672087;3088024;7584063;297437
2022;6;Steiermark;21219635;5888399;15331236;591404
2022;7;Tirol;9627661;3882827;5744834;268329
2022;8;Vorarlberg;7108114;1557025;5551089;198107
2022;9;Wien;66507145;58887300;7619845;1853593
2022;10;Österreich;191428491;97248558;94179933;5335225
2022;1;Burgenland;5365533;1802218;3563315;149541
2022;2;Kärnten;6648981;1543173;5105808;185311
2022;3;Niederösterreich;39657940;14295042;25362898;1105290
2022;4;Oberösterreich;24633883;6315389;18318494;686561
2022;5;Salzburg;10673599;3089340;7584259;297480
2022;6;Steiermark;21223319;5891683;15331636;591506
2022;7;Tirol;9629293;3884459;5744834;268374
2022;8;Vorarlberg;7109521;1558106;5551415;198147
2022;9;Wien;66550923;58930581;7620342;1854813
2022;10;Österreich;191492992;97309991;94183001;5337023
2022;1;Burgenland;5368444;1804686;3563758;149622
2022;2;Kärnten;6651629;1545295;5106334;185385
2022;3;Niederösterreich;39666179;14301324;25364855;1105520
2022;4;Oberösterreich;24645247;6319970;18325277;686878
2022;5;Salzburg;10683580;3091494;7592086;297758
2022;6;Steiermark;21230164;5897019;15333145;591697
2022;7;Tirol;9632046;3887212;5744834;268451
2022;8;Vorarlberg;7112017;1559754;5552263;198216
2022;9;Wien;66613096;58992296;7620800;1856546
2022;10;Österreich;191602402;97399050;94203352;5340072
2022;1;Burgenland;5373526;1809566;3563960;149763
2022;2;Kärnten;6654282;1546530;5107752;185459
2022;3;Niederösterreich;39677515;14308545;25368970;1105836
2022;4;Oberösterreich;24652052;6323202;18328850;687067
2022;5;Salzburg;10686550;3094170;7592380;297840
2022;6;Steiermark;21252367;5904832;15347535;592316
2022;7;Tirol;9637903;3893069;5744834;268614
2022;8;Vorarlberg;7114027;1561136;5552891;198272
2022;9;Wien;66675486;59054259;7621227;1858285
2022;10;Österreich;191723708;97495309;94228399;5343453
2022;1;Burgenland;5377607;1812885;3564722;149877
2022;2;Kärnten;6657085;1548231;5108854;185537
2022;3;Niederösterreich;39777639;14352816;25424823;1108626
2022;4;Oberösterreich;24667330;6326551;18340779;687493
2022;5;Salzburg;10688978;3096301;7592677;297908
2022;6;Steiermark;21259968;5911277;15348691;592528
2022;7;Tirol;9641775;3896941;5744834;268722
2022;8;Vorarlberg;7115881;1562375;5553506;198324
2022;9;Wien;66719270;59097657;7621613;1859505
2022;10;Österreich;191905533;97605034;94300499;5348520
2022;1;Burgenland;5381025;1816053;3564972;149972
2022;2;Kärnten;6658579;1549723;5108856;185579
2022;3;Niederösterreich;39838742;14357868;25480874;1110329
2022;4;Oberösterreich;24673597;6330917;18342680;687668
2022;5;Salzburg;10691173;3098220;7592953;297969
2022;6;Steiermark;21268592;5918759;15349833;592768
2022;7;Tirol;9645151;3900317;5744834;268816
2022;8;Vorarlberg;7117859;1563586;5554273;198379
2022;9;Wien;66785398;59163418;7621980;1861348
2022;10;Österreich;192060116;97698861;94361255;5352829
2022;1;Burgenland;5385054;1819345;3565709;150085
2022;2;Kärnten;6659413;1550546;5108867;185602
2022;3;Niederösterreich;39884068;14364167;25519901;1111593
2022;4;Oberösterreich;24678989;6334836;18344153;687818
2022;5;Salzburg;10693771;3100557;7593214;298042
2022;6;Steiermark;21275146;5924325;15350821;592951
2022;7;Tirol;9648500;3903666;5744834;268909
2022;8;Vorarlberg;7119678;1564912;5554766;198430
2022;9;Wien;66830556;59208228;7622328;1862607
2022;10;Österreich;192175175;97770582;94404593;5356036
2022;1;Burgenland;5388090;1822227;3565863;150169
2022;2;Kärnten;6660190;1551322;5108868;185623
2022;3;Niederösterreich;39889826;14369760;25520066;1111753
2022;4;Oberösterreich;24683122;6338205;18344917;687933
2022;5;Salzburg;10695418;3102022;7593396;298088
2022;6;Steiermark;21281451;5930167;15351284;593127
2022;7;Tirol;9651455;3906621;5744834;268992
2022;8;Vorarlberg;7121238;1566214;5555024;198473
2022;9;Wien;66870325;59247583;7622742;1863715
2022;10;Österreich;192241115;97834121;94406994;5357873
2022;1;Burgenland;5390688;1824814;3565874;150242
2022;2;Kärnten;6661424;1552530;5108894;185658
2022;3;Niederösterreich;39895021;14374768;25520253;1111898
2022;4;Oberösterreich;24686881;6340709;18346172;688038
2022;5;Salzburg;10697084;3103532;7593552;298134
2022;6;Steiermark;21284285;5932648;15351637;593206
2022;7;Tirol;9653609;3908775;5744834;269052
2022;8;Vorarlberg;7122654;1567366;5555288;198513
2022;9;Wien;66907087;59283790;7623297;1864740
2022;10;Österreich;192298733;97888932;94409801;5359479
2022;1;Burgenland;5393358;1827138;3566220;150316
2022;2;Kärnten;6665291;1554534;5110757;185766
2022;3;Niederösterreich;39904081;14381139;25522942;1112150
2022;4;Oberösterreich;24697987;6345107;18352880;688347
2022;5;Salzburg;10715086;3106001;7609085;298636
2022;6;Steiermark;21290421;5937277;15353144;593377
2022;7;Tirol;9658270;3913436;5744834;269182
2022;8;Vorarlberg;7124714;1568600;5556114;198570
2022;9;Wien;66969595;59345776;7623819;1866482
2022;10;Österreich;192418803;97979008;94439795;5362826
2022;1;Burgenland;5398937;1832049;3566888;150472
2022;2;Kärnten;6668335;1555992;5112343;185850
2022;3;Niederösterreich;39914099;14385943;25528156;1112429
2022;4;Oberösterreich;24704808;6348700;18356108;688538
2022;5;Salzburg;10716500;3107158;7609342;298675
2022;6;Steiermark;21313183;5946283;15366900;594011
2022;7;Tirol;9662033;3917199;5744834;269287
2022;8;Vorarlberg;7126728;1569994;5556734;198626
2022;9;Wien;67028543;59404205;7624338;1868125
2022;10;Österreich;192533166;98067523;94465643;5366013
2022;1;Burgenland;5402547;1835288;3567259;150572
2022;2;Kärnten;6670359;1558016;5112343;185907
2022;3;Niederösterreich;39924726;14393132;25531594;1112726
2022;4;Oberösterreich;24719530;6351937;18367593;688948
2022;5;Salzburg;10718677;3109060;7609617;298736
2022;6;Steiermark;21320685;5952673;15368012;594220
2022;7;Tirol;9665356;3920522;5744834;269379
2022;8;Vorarlberg;7128622;1571313;5557309;198679
2022;9;Wien;67083943;59459217;7624726;1869669
2022;10;Österreich;192634445;98151158;94483287;5368836
2022;1;Burgenland;5405836;1838237;3567599;150664
2022;2;Kärnten;6671499;1559150;5112349;185939
2022;3;Niederösterreich;39969762;14436018;25533744;1113981
2022;4;Oberösterreich;24724960;6355695;18369265;689099
2022;5;Salzburg;10721235;3111335;7609900;298807
2022;6;Steiermark;21327008;5957953;15369055;594396
2022;7;Tirol;9668414;3923580;5744834;269464
2022;8;Vorarlberg;7130332;1572549;5557783;198727
2022;9;Wien;67134193;59509072;7625121;1871070
2022;10;Österreich;192753239;98263589;94489650;5372146
2022;1;Burgenland;5411364;1841466;3569898;150818
2022;2;Kärnten;6672461;1560034;5112427;185965
2022;3;Niederösterreich;39977620;14441935;25535685;1114200
2022;4;Oberösterreich;24729909;6359266;18370643;689237
2022;5;Salzburg;10722975;3112858;7610117;298856
2022;6;Steiermark;21333135;5963234;15369901;594567
2022;7;Tirol;9671390;3926556;5744834;269547
2022;8;Vorarlberg;7131971;1573593;5558378;198772
2022;9;Wien;67182268;59556806;7625462;1872409
2022;10;Österreich;192833093;98335748;94497345;5374372
2022;1;Burgenland;5414438;1844499;3569939;150904
2022;2;Kärnten;6673285;1560856;5112429;185988
2022;3;Niederösterreich;39983787;14447938;25535849;1114372
2022;4;Oberösterreich;24733921;6362413;18371508;689349
2022;5;Salzburg;10725083;3114800;7610283;298914
2022;6;Steiermark;21339044;5968705;15370339;594732
2022;7;Tirol;9674185;3929351;5744834;269625
2022;8;Vorarlberg;7132855;1574217;5558638;198797
2022;9;Wien;67218613;59592785;7625828;1873422
2022;10;Österreich;192895211;98395564;94499647;5376103
2022;1;Burgenland;5416819;1846840;3569979;150970
2022;2;Kärnten;6674704;1562129;5112575;186028
2022;3;Niederösterreich;39988578;14452486;25536092;1114505
2022;4;Oberösterreich;24737570;6364808;18372762;689451
2022;5;Salzburg;10726469;3116010;7610459;298953
2022;6;Steiermark;21342628;5971929;15370699;594832
2022;7;Tirol;9675954;3931120;5744834;269675
2022;8;Vorarlberg;7134043;1575108;5558935;198830
2022;9;Wien;67250277;59624016;7626261;1874305
2022;10;Österreich;192947042;98444446;94502596;5377548
2022;1;Burgenland;5421107;1850490;3570617;151089
2022;2;Kärnten;6677623;1564089;5113534;186109
2022;3;Niederösterreich;39996701;14458989;25537712;1114732
2022;4;Oberösterreich;24738745;6365983;18372762;689483
2022;5;Salzburg;10743852;3118314;7625538;299437
2022;6;Steiermark;21347987;5975839;15372148;594981
2022;7;Tirol;9679934;3935100;5744834;269785
2022;8;Vorarlberg;7135553;1575919;5559634;198872
2022;9;Wien;67308909;59682176;7626733;1875939
2022;10;Österreich;193050411;98526899;94523512;5380429
2022;1;Burgenland;5424891;1854078;3570813;151195
2022;2;Kärnten;6680843;1565594;5115249;186199
2022;3;Niederösterreich;40008148;14465589;25542559;1115051
2022;4;Oberösterreich;24752661;6371231;18381430;689871
2022;5;Salzburg;10745908;3120113;7625795;299495
2022;6;Steiermark;21367225;5982768;15384457;595517
2022;7;Tirol;9682922;3938088;5744834;269869
2022;8;Vorarlberg;7137075;1576924;5560151;198914
2022;9;Wien;67363271;59736110;7627161;1877454
2022;10;Österreich;193162944;98610495;94552449;5383565
2022;1;Burgenland;5428578;1857643;3570935;151298
2022;2;Kärnten;6682550;1567301;5115249;186247
2022;3;Niederösterreich;40014472;14470606;25543866;1115227
2022;4;Oberösterreich;24767991;6373815;18394176;690299
2022;5;Salzburg;10748133;3122090;7626043;299557
2022;6;Steiermark;21369168;5984377;15384791;595571
2022;7;Tirol;9685549;3940715;5744834;269942
2022;8;Vorarlberg;7138130;1577530;5560600;198944
2022;9;Wien;67410998;59783470;7627528;1878784
2022;10;Österreich;193245569;98677547;94568022;5385868
2022;1;Burgenland;5431870;1860587;3571283;151389
2022;2;Kärnten;6687719;1568250;5119469;186391
2022;3;Niederösterreich;40021893;14476721;25545172;1115434
2022;4;Oberösterreich;24772810;6376915;18395895;690433
2022;5;Salzburg;10750134;3123840;7626294;299613
2022;6;Steiermark;21380122;5993621;15386501;595877
2022;7;Tirol;9687608;3942774;5744834;269999
2022;8;Vorarlberg;7139587;1578190;5561397;198985
2022;9;Wien;67455627;59827696;7627931;1880028
2022;10;Österreich;193327370;98748594;94578776;5388148
2022;1;Burgenland;5435536;1863595;3571941;151492
2022;2;Kärnten;6688509;1569015;5119494;186413
2022;3;Niederösterreich;40028986;14482561;25546425;1115631
2022;4;Oberösterreich;24776830;6379547;18397283;690545
2022;5;Salzburg;10751721;3125180;7626541;299657
2022;6;Steiermark;21384960;5997606;15387354;596011
2022;7;Tirol;9689884;3945050;5744834;270063
2022;8;Vorarlberg;7140525;1578753;5561772;199011
2022;9;Wien;67497217;59868879;7628338;1881187
2022;10;Österreich;193394168;98810186;94583982;5390010
2022;1;Burgenland;5438338;1866231;3572107;151570
2022;2;Kärnten;6689261;1569767;5119494;186434
2022;3;Niederösterreich;40035500;14488914;25546586;1115813
2022;4;Oberösterreich;24779626;6381543;18398083;690623
2022;5;Salzburg;10752939;3126250;7626689;299691
2022;6;Steiermark;21385712;5998183;15387529;596032
2022;7;Tirol;9691849;3947015;5744834;270118
2022;8;Vorarlberg;7141254;1579293;5561961;199031
2022;9;Wien;67529552;59900895;7628657;1882088
2022;10;Österreich;193444031;98858091;94585940;5391399
2022;1;Burgenland;5439904;1867748;3572156;151613
2022;2;Kärnten;6689958;1570382;5119576;186453
2022;3;Niederösterreich;40039754;14492950;25546804;1115932
2022;4;Oberösterreich;24782536;6383203;18399333;690704
2022;5;Salzburg;10754300;3127451;7626849;299729
2022;6;Steiermark;21393094;6004862;15388232;596238
2022;7;Tirol;9693371;3948537;5744834;270160
2022;8;Vorarlberg;7141820;1579666;5562154;199047
2022;9;Wien;67560959;59931890;7629069;1882964
2022;10;Österreich;193495696;98906689;94589007;5392839
2022;1;Burgenland;5443162;1870612;3572550;151704
2022;2;Kärnten;6693361;1572075;5121286;186548
2022;3;Niederösterreich;40047037;14497517;25549520;1116135
2022;4;Oberösterreich;24791930;6385439;18406491;690966
2022;5;Salzburg;10770057;3129192;7640865;300168
2022;6;Steiermark;21397591;6008103;15389488;596363
2022;7;Tirol;9696314;3951480;5744834;270242
2022;8;Vorarlberg;7142846;1580129;5562717;199075
2022;9;Wien;67615728;59986257;7629471;1884490
2022;10;Österreich;193598026;98980804;94617222;5395691
2022;1;Burgenland;5446623;1873686;3572937;151801
2022;2;Kärnten;6695948;1573549;5122399;186620
2022;3;Niederösterreich;40057375;14503045;25554330;1116423
2022;4;Oberösterreich;24796644;6388020;18408624;691097
2022;5;Salzburg;10764312;3130560;7633752;300008
2022;6;Steiermark;21405533;6014434;15391099;596585
2022;7;Tirol;9698384;3953550;5744834;270300
2022;8;Vorarlberg;7143899;1580629;5563270;199105
2022;9;Wien;67662871;60033041;7629830;1885804
2022;10;Österreich;193671589;99050514;94621075;5397741
2022;1;Burgenland;5450697;1877494;3573203;151914
2022;2;Kärnten;6700916;1575053;5125863;186758
2022;3;Niederösterreich;40064733;14508514;25556219;1116628
2022;4;Oberösterreich;24809235;6390063;18419172;691448
2022;5;Salzburg;10765890;3131891;7633999;300052
2022;6;Steiermark;21423402;6018876;15404526;597083
2022;7;Tirol;9700638;3955804;5744834;270363
2022;8;Vorarlberg;7144801;1581142;5563659;199130
2022;9;Wien;67705425;60075285;7630140;1886990
2022;10;Österreich;193765737;99114122;94651615;5400365
2022;1;Burgenland;5453483;1880234;3573249;151992
2022;2;Kärnten;6701651;1575786;5125865;186779
2022;3;Niederösterreich;40071127;14513034;25558093;1116806
2022;4;Oberösterreich;24813114;6392516;18420598;691556
2022;5;Salzburg;10767164;3132937;7634227;300087
2022;6;Steiermark;21428595;6023126;15405469;597228
2022;7;Tirol;9702548;3957714;5744834;270416
2022;8;Vorarlberg;7145558;1581544;5564014;199151
2022;9;Wien;67747707;60117240;7630467;1888169
2022;10;Österreich;193830947;99174131;94656816;5402183
2022;1;Burgenland;5456625;1882845;3573780;152079
2022;2;Kärnten;6702198;1576324;5125874;186794
2022;3;Niederösterreich;40077996;14518071;25559925;1116997
2022;4;Oberösterreich;24816386;6394526;18421860;691647
2022;5;Salzburg;10768420;3133974;7634446;300122
2022;6;Steiermark;21433316;6026967;15406349;597359
2022;7;Tirol;9704406;3959572;5744834;270468
2022;8;Vorarlberg;7146215;1581901;5564314;199169
2022;9;Wien;67786776;60155984;7630792;1889257
2022;10;Österreich;193892338;99230164;94662174;5403894
2022;1;Burgenland;5457842;1885026;3572816;152113
2022;2;Kärnten;6702396;1576521;5125875;186800
2022;3;Niederösterreich;40082345;14522262;25560083;1117119
2022;4;Oberösterreich;24818790;6396075;18422715;691714
2022;5;Salzburg;10769423;3134815;7634608;300150
2022;6;Steiermark;21437786;6031045;15406741;597484
2022;7;Tirol;9706274;3961440;5744834;270520
2022;8;Vorarlberg;7146873;1582352;5564521;199188
2022;9;Wien;67813878;60182763;7631115;1890013
2022;10;Österreich;193935607;99272299;94663308;5405100
2022;1;Burgenland;5460710;1886869;3573841;152193
2022;2;Kärnten;6703539;1577644;5125895;186832
2022;3;Niederösterreich;40085903;14525597;25560306;1117218
2022;4;Oberösterreich;24821600;6397546;18424054;691793
2022;5;Salzburg;10770393;3135612;7634781;300177
2022;6;Steiermark;21440447;6033390;15407057;597558
2022;7;Tirol;9707379;3962545;5744834;270550
2022;8;Vorarlberg;7147432;1582708;5564724;199203
2022;9;Wien;67813878;60182763;7631115;1890013
2022;10;Österreich;193951281;99284674;94666607;5405537
2022;1;Burgenland;5463047;1889042;3574005;152258
2022;2;Kärnten;6706392;1579536;5126856;186911
2022;3;Niederösterreich;40093351;14530022;25563329;1117425
2022;4;Oberösterreich;24828664;6399669;18428995;691990
2022;5;Salzburg;10778754;3137034;7641720;300410
2022;6;Steiermark;21453483;6036792;15416691;597921
2022;7;Tirol;9708489;3963655;5744834;270581
2022;8;Vorarlberg;7148141;1582854;5565287;199223
2022;9;Wien;67887487;60255662;7631825;1892064
2022;10;Österreich;194067808;99374266;94693542;5408784
2022;1;Burgenland;5467146;1892929;3574217;152373
2022;2;Kärnten;6709528;1580572;5128956;186999
2022;3;Niederösterreich;40100776;14532984;25567792;1117632
2022;4;Oberösterreich;24834405;6401475;18432930;692150
2022;5;Salzburg;10780094;3138117;7641977;300448
2022;6;Steiermark;21471878;6042765;15429113;598434
2022;7;Tirol;9712234;3967400;5744834;270686
2022;8;Vorarlberg;7149055;1583359;5565696;199248
2022;9;Wien;67933060;60300938;7632122;1893334
2022;10;Österreich;194158176;99440539;94717637;5411303
2022;1;Burgenland;5469728;1895354;3574374;152445
2022;2;Kärnten;6710491;1581529;5128962;187025
2022;3;Niederösterreich;40106757;14537535;25569222;1117799
2022;4;Oberösterreich;24849502;6403236;18446266;692570
2022;5;Salzburg;10781715;3139485;7642230;300493
2022;6;Steiermark;21476881;6046800;15430081;598573
2022;7;Tirol;9713552;3968718;5744834;270722
2022;8;Vorarlberg;7150058;1583840;5566218;199276
2022;9;Wien;67973695;60341223;7632472;1894467
2022;10;Österreich;194232379;99497720;94734659;5413371
2022;1;Burgenland;5472465;1897831;3574634;152521
2022;2;Kärnten;6712921;1582345;5130576;187093
2022;3;Niederösterreich;40111965;14541403;25570562;1117944
2022;4;Oberösterreich;24853490;6405562;18447928;692681
2022;5;Salzburg;10783017;3140546;7642471;300529
2022;6;Steiermark;21482418;6051406;15431012;598728
2022;7;Tirol;9716103;3971269;5744834;270794
2022;8;Vorarlberg;7151018;1584307;5566711;199303
2022;9;Wien;68015353;60382541;7632812;1895628
2022;10;Österreich;194298750;99557210;94741540;5415221
2022;1;Burgenland;5474896;1900171;3574725;152589
2022;2;Kärnten;6713538;1582962;5130576;187110
2022;3;Niederösterreich;40117431;14545551;25571880;1118096
2022;4;Oberösterreich;24856828;6407511;18449317;692774
2022;5;Salzburg;10784129;3141432;7642697;300560
2022;6;Steiermark;21486967;6055103;15431864;598854
2022;7;Tirol;9717862;3973028;5744834;270843
2022;8;Vorarlberg;7151738;1584717;5567021;199323
2022;9;Wien;68053838;60420712;7633126;1896701
2022;10;Österreich;194357227;99611187;94746040;5416851
2022;1;Burgenland;5477267;1902403;3574864;152655
2022;2;Kärnten;6714077;1583498;5130579;187125
2022;3;Niederösterreich;40121010;14548977;25572033;1118196
2022;4;Oberösterreich;24859077;6408878;18450199;692837
2022;5;Salzburg;10785061;3142220;7642841;300586
2022;6;Steiermark;21491452;6059160;15432292;598979
2022;7;Tirol;9719418;3974584;5744834;270886
2022;8;Vorarlberg;7152328;1585088;5567240;199340
2022;9;Wien;68078931;60445475;7633456;1897400
2022;10;Österreich;194398621;99650283;94748338;5418004
2022;1;Burgenland;5478791;1903894;3574897;152697
2022;2;Kärnten;6714315;1583736;5130579;187132
2022;3;Niederösterreich;40123680;14551452;25572228;1118271
2022;4;Oberösterreich;24861205;6410091;18451114;692896
2022;5;Salzburg;10785920;3142941;7642979;300610
2022;6;Steiermark;21493246;6060703;15432543;599029
2022;7;Tirol;9720433;3975599;5744834;270914
2022;8;Vorarlberg;7152818;1585425;5567393;199353
2022;9;Wien;68099495;60465712;7633783;1897973
2022;10;Österreich;194429903;99679553;94750350;5418876
2022;1;Burgenland;5480264;1905330;3574934;152738
2022;2;Kärnten;6715526;1584779;5130747;187166
2022;3;Niederösterreich;40127984;14554547;25573437;1118391
2022;4;Oberösterreich;24864806;6412154;18452652;692997
2022;5;Salzburg;10786916;3143715;7643201;300638
2022;6;Steiermark;21495175;6062143;15433032;599083
2022;7;Tirol;9721700;3976866;5744834;270950
2022;8;Vorarlberg;7153329;1585683;5567646;199367
2022;9;Wien;68128010;60493857;7634153;1898768
2022;10;Österreich;194473710;99719074;94754636;5420097
2022;1;Burgenland;5484545;1907829;3576716;152858
2022;2;Kärnten;6718862;1587022;5131840;187259
2022;3;Niederösterreich;40135299;14558392;25576907;1118594
2022;4;Oberösterreich;24874151;6414207;18459944;693257
2022;5;Salzburg;10794993;3145068;7649925;300863
2022;6;Steiermark;21508792;6065218;15443574;599463
2022;7;Tirol;9724392;3979558;5744834;271025
2022;8;Vorarlberg;7154444;1586019;5568425;199399
2022;9;Wien;68178379;60543783;7634596;1900172
2022;10;Österreich;194573857;99787096;94786761;5422888
2022;1;Burgenland;5488606;1911551;3577055;152971
2022;2;Kärnten;6721224;1588700;5132524;187324
2022;3;Niederösterreich;40140211;14562098;25578113;1118731
2022;4;Oberösterreich;24885204;6415858;18469346;693565
2022;5;Salzburg;10796587;3146395;7650192;300907
2022;6;Steiermark;21517391;6072680;15444711;599702
2022;7;Tirol;9726506;3981672;5744834;271083
2022;8;Vorarlberg;7155419;1586556;5568863;199426
2022;9;Wien;68223259;60588335;7634924;1901422
2022;10;Österreich;194654407;99853845;94800562;5425133
2022;1;Burgenland;5491572;1913814;3577758;153053
2022;2;Kärnten;6725025;1589580;5135445;187430
2022;3;Niederösterreich;40144267;14565177;25579090;1118844
2022;4;Oberösterreich;24888722;6417454;18471268;693663
2022;5;Salzburg;10797897;3147473;7650424;300944
2022;6;Steiermark;21522572;6076805;15445767;599847
2022;7;Tirol;9728204;3983370;5744834;271131
2022;8;Vorarlberg;7156307;1587000;5569307;199450
2022;9;Wien;68262725;60627553;7635172;1902522
2022;10;Österreich;194717291;99908226;94809065;5426886
2022;1;Burgenland;5496392;1916104;3580288;153188
2022;2;Kärnten;6725664;1590206;5135458;187448
2022;3;Niederösterreich;40148062;14568022;25580040;1118950
2022;4;Oberösterreich;24893026;6420254;18472772;693783
2022;5;Salzburg;10799034;3148402;7650632;300975
2022;6;Steiermark;21527554;6080858;15446696;599986
2022;7;Tirol;9729961;3985127;5744834;271180
2022;8;Vorarlberg;7157051;1587441;5569610;199471
2022;9;Wien;68295069;60659574;7635495;1903424
2022;10;Österreich;194771813;99955988;94815825;5428405
2022;1;Burgenland;5498718;1918410;3580308;153253
2022;2;Kärnten;6726181;1590723;5135458;187463
2022;3;Niederösterreich;40152186;14571986;25580200;1119065
2022;4;Oberösterreich;24895370;6421660;18473710;693849
2022;5;Salzburg;10800096;3149324;7650772;301005
2022;6;Steiermark;21532279;6085164;15447115;600117
2022;7;Tirol;9731457;3986623;5744834;271221
2022;8;Vorarlberg;7157609;1587831;5569778;199487
2022;9;Wien;68324436;60688676;7635760;1904242
2022;10;Österreich;194818332;100000397;94817935;5429702
2022;1;Burgenland;5500651;1920235;3580416;153306
2022;2;Kärnten;6727095;1591637;5135458;187488
2022;3;Niederösterreich;40154935;14574530;25580405;1119142
2022;4;Oberösterreich;24898338;6423140;18475198;693931
2022;5;Salzburg;10800980;3149993;7650987;301030
2022;6;Steiermark;21534576;6087060;15447516;600181
2022;7;Tirol;9732492;3987658;5744834;271250
2022;8;Vorarlberg;7158120;1588185;5569935;199501
2022;9;Wien;68349784;60713685;7636099;1904949
2022;10;Österreich;194856971;100036123;94820848;5430779
2022;1;Burgenland;5503731;1922856;3580875;153392
2022;2;Kärnten;6729633;1593381;5136252;187559
2022;3;Niederösterreich;40160381;14578267;25582114;1119294
2022;4;Oberösterreich;24906836;6425288;18481548;694168
2022;5;Salzburg;10808801;3151331;7657470;301248
2022;6;Steiermark;21538931;6089827;15449104;600303
2022;7;Tirol;9734873;3990039;5744834;271317
2022;8;Vorarlberg;7159086;1588532;5570554;199528
2022;9;Wien;68398000;60761566;7636434;1906293
2022;10;Österreich;194940272;100101087;94839185;5433100
2022;1;Burgenland;5507033;1925969;3581064;153484
2022;2;Kärnten;6731531;1594253;5137278;187612
2022;3;Niederösterreich;40166179;14581889;25584290;1119455
2022;4;Oberösterreich;24932796;6427014;18505782;694892
2022;5;Salzburg;10810268;3152527;7657741;301289
2022;6;Steiermark;21559360;6095578;15463782;600872
2022;7;Tirol;9736837;3992003;5744834;271371
2022;8;Vorarlberg;7160020;1589042;5570978;199554
2022;9;Wien;68443284;60806601;7636683;1907555
2022;10;Österreich;195047308;100164876;94882432;5436084
2022;1;Burgenland;5510520;1928374;3582146;153581
2022;2;Kärnten;6732884;1595606;5137278;187649
2022;3;Niederösterreich;40174347;14585545;25588802;1119683
2022;4;Oberösterreich;24948025;6429017;18519008;695316
2022;5;Salzburg;10811497;3153469;7658028;301323
2022;6;Steiermark;21565181;6100260;15464921;601034
2022;7;Tirol;9738747;3993913;5744834;271425
2022;8;Vorarlberg;7160835;1589439;5571396;199577
2022;9;Wien;68483331;60846386;7636945;1908671
2022;10;Österreich;195125367;100222009;94903358;5438259
2022;1;Burgenland;5513239;1930827;3582412;153657
2022;2;Kärnten;6735050;1596350;5138700;187710
2022;3;Niederösterreich;40178873;14588447;25590426;1119809
2022;4;Oberösterreich;24952740;6431691;18521049;695448
2022;5;Salzburg;10812811;3154513;7658298;301359
2022;6;Steiermark;21570819;6104808;15466011;601191
2022;7;Tirol;9740382;3995548;5744834;271470
2022;8;Vorarlberg;7161617;1589837;5571780;199598
2022;9;Wien;68521657;60884436;7637221;1909739
2022;10;Österreich;195187188;100276457;94910731;5439982
2022;1;Burgenland;5516401;1933199;3583202;153745
2022;2;Kärnten;6735633;1596922;5138711;187726
2022;3;Niederösterreich;40184297;14592209;25592088;1119960
2022;4;Oberösterreich;24956520;6433715;18522805;695553
2022;5;Salzburg;10813884;3155331;7658553;301389
2022;6;Steiermark;21575651;6108659;15466992;601326
2022;7;Tirol;9741999;3997165;5744834;271515
2022;8;Vorarlberg;7162391;1590204;5572187;199620
2022;9;Wien;68557784;60920239;7637545;1910746
2022;10;Österreich;195244560;100327643;94916917;5441581
2022;1;Burgenland;5518465;1935166;3583299;153803
2022;2;Kärnten;6736252;1597541;5138711;187743
2022;3;Niederösterreich;40187937;14595673;25592264;1120062
2022;4;Oberösterreich;24959204;6435469;18523735;695628
2022;5;Salzburg;10814836;3156110;7658726;301416
2022;6;Steiermark;21580716;6113301;15467415;601467
2022;7;Tirol;9743501;3998667;5744834;271557
2022;8;Vorarlberg;7162896;1590550;5572346;199634
2022;9;Wien;68582489;60944700;7637789;1911434
2022;10;Österreich;195286296;100367177;94919119;5442744
2022;1;Burgenland;5520219;1936860;3583359;153852
2022;2;Kärnten;6737114;1598403;5138711;187767
2022;3;Niederösterreich;40190517;14598061;25592456;1120133
2022;4;Oberösterreich;24962086;6436749;18525337;695708
2022;5;Salzburg;10815691;3156787;7658904;301440
2022;6;Steiermark;21582546;6114728;15467818;601518
2022;7;Tirol;9744583;3999749;5744834;271587
2022;8;Vorarlberg;7163489;1590929;5572560;199651
2022;9;Wien;68606715;60968632;7638083;1912110
2022;10;Österreich;195322960;100400898;94922062;5443766
2022;1;Burgenland;5524664;1939585;3585079;153976
2022;2;Kärnten;6740556;1599834;5140722;187863
2022;3;Niederösterreich;40196114;14602157;25593957;1120289
2022;4;Oberösterreich;24970528;6438749;18531779;695943
2022;5;Salzburg;10823784;3158005;7665779;301665
2022;6;Steiermark;21587056;6117699;15469357;601644
2022;7;Tirol;9747182;4002348;5744834;271660
2022;8;Vorarlberg;7164467;1591211;5573256;199678
2022;9;Wien;68655830;61017433;7638397;1913478
2022;10;Österreich;195410181;100467021;94943160;5446197
2022;1;Burgenland;5528320;1942619;3585701;154078
2022;2;Kärnten;6742322;1600895;5141427;187912
2022;3;Niederösterreich;40201742;14606140;25595602;1120446
2022;4;Oberösterreich;24976079;6440818;18535261;696098
2022;5;Salzburg;10825240;3159179;7666061;301706
2022;6;Steiermark;21607277;6123396;15483881;602208
2022;7;Tirol;9749103;4004269;5744834;271713
2022;8;Vorarlberg;7165469;1591687;5573782;199706
2022;9;Wien;68700674;61061978;7638696;1914728
2022;10;Österreich;195496226;100530981;94965245;5448595
2022;1;Burgenland;5531223;1945275;3585948;154158
2022;2;Kärnten;6743726;1602297;5141429;187952
2022;3;Niederösterreich;40207375;14609927;25597448;1120603
2022;4;Oberösterreich;24988498;6442382;18546116;696444
2022;5;Salzburg;10826520;3160148;7666372;301742
2022;6;Steiermark;21612604;6127511;15485093;602356
2022;7;Tirol;9750924;4006090;5744834;271764
2022;8;Vorarlberg;7166269;1592076;5574193;199728
2022;9;Wien;68740776;61101801;7638975;1915846
2022;10;Österreich;195567915;100587507;94980408;5450593
2022;1;Burgenland;5533576;1947584;3585992;154224
2022;2;Kärnten;6745555;1603057;5142498;188003
2022;3;Niederösterreich;40214618;14612618;25602000;1120805
2022;4;Oberösterreich;24992947;6444668;18548279;696568
2022;5;Salzburg;10827745;3161094;7666651;301776
2022;6;Steiermark;21618278;6132070;15486208;602514
2022;7;Tirol;9752633;4007799;5744834;271812
2022;8;Vorarlberg;7167027;1592451;5574576;199749
2022;9;Wien;68782493;61143260;7639233;1917009
2022;10;Österreich;195634872;100644601;94990271;5452459
2022;1;Burgenland;5537612;1949964;3587648;154337
2022;2;Kärnten;6746013;1603499;5142514;188015
2022;3;Niederösterreich;40219947;14616564;25603383;1120954
2022;4;Oberösterreich;24996862;6446865;18549997;696677
2022;5;Salzburg;10828628;3161749;7666879;301800
2022;6;Steiermark;21622768;6135631;15487137;602639
2022;7;Tirol;9754010;4009176;5744834;271850
2022;8;Vorarlberg;7167722;1592830;5574892;199769
2022;9;Wien;68818049;61178560;7639489;1918000
2022;10;Österreich;195691611;100694838;94996773;5454041
2022;1;Burgenland;5540012;1952258;3587754;154403
2022;2;Kärnten;6746475;1603961;5142514;188028
2022;3;Niederösterreich;40223550;14619997;25603553;1121054
2022;4;Oberösterreich;24999448;6448545;18550903;696749
2022;5;Salzburg;10829599;3162598;7667001;301827
2022;6;Steiermark;21627127;6139624;15487503;602761
2022;7;Tirol;9755375;4010541;5744834;271888
2022;8;Vorarlberg;7168272;1593210;5575062;199784
2022;9;Wien;68852238;61212516;7639722;1918952
2022;10;Österreich;195742096;100743250;94998846;5455448
2022;1;Burgenland;5542720;1954902;3587818;154479
2022;2;Kärnten;6747426;1604867;5142559;188055
2022;3;Niederösterreich;40226903;14622922;25603981;1121148
2022;4;Oberösterreich;25002524;6449998;18552526;696835
2022;5;Salzburg;10830395;3163209;7667186;301849
2022;6;Steiermark;21629364;6141427;15487937;602823
2022;7;Tirol;9756234;4011400;5744834;271912
2022;8;Vorarlberg;7168784;1593535;5575249;199798
2022;9;Wien;68928268;61287987;7640281;1921071
2022;10;Österreich;195832618;100830247;95002371;5457971
2022;1;Burgenland;5546821;1958682;3588139;154593
2022;2;Kärnten;6749264;1606367;5142897;188106
2022;3;Niederösterreich;40234583;14626699;25607884;1121362
2022;4;Oberösterreich;25022356;6452070;18570286;697388
2022;5;Salzburg;10838281;3164384;7673897;302069
2022;6;Steiermark;21634133;6144521;15489612;602956
2022;7;Tirol;9758592;4013758;5744834;271978
2022;8;Vorarlberg;7169710;1593802;5575908;199824
2022;9;Wien;69012510;61371836;7640674;1923419
2022;10;Österreich;195966250;100932119;95034131;5461695
2022;1;Burgenland;5550309;1961482;3588827;154690
2022;2;Kärnten;6750227;1606956;5143271;188133
2022;3;Niederösterreich;40239480;14629677;25609803;1121498
2022;4;Oberösterreich;25028770;6453809;18574961;697567
2022;5;Salzburg;10839632;3165436;7674196;302107
2022;6;Steiermark;21653682;6151228;15502454;603501
2022;7;Tirol;9760324;4015490;5744834;272026
2022;8;Vorarlberg;7170713;1594259;5576454;199852
2022;9;Wien;69056241;61415300;7640941;1924638
2022;10;Österreich;196049378;100993637;95055741;5464012
2022;1;Burgenland;5553495;1964106;3589389;154779
2022;2;Kärnten;6753173;1608466;5144707;188215
2022;3;Niederösterreich;40247109;14636152;25610957;1121711
2022;4;Oberösterreich;25042835;6455586;18587249;697959
2022;5;Salzburg;10840927;3166430;7674497;302143
2022;6;Steiermark;21659074;6155377;15503697;603651
2022;7;Tirol;9762018;4017184;5744834;272073
2022;8;Vorarlberg;7171529;1594649;5576880;199875
2022;9;Wien;69096055;61454876;7641179;1925748
2022;10;Österreich;196126215;101052826;95073389;5466153
2022;1;Burgenland;5556059;1966460;3589599;154851
2022;2;Kärnten;6755375;1609189;5146186;188276
2022;3;Niederösterreich;40252513;14639985;25612528;1121861
2022;4;Oberösterreich;25047632;6458170;18589462;698092
2022;5;Salzburg;10842149;3167364;7674785;302177
2022;6;Steiermark;21666810;6161988;15504822;603867
2022;7;Tirol;9763401;4018567;5744834;272112
2022;8;Vorarlberg;7172349;1595031;5577318;199898
2022;9;Wien;69096055;61454876;7641179;1925748
2022;10;Österreich;196152343;101071630;95080713;5466882
2022;1;Burgenland;5559855;1968819;3591036;154956
2022;2;Kärnten;6755895;1609689;5146206;188291
2022;3;Niederösterreich;40258228;14644415;25613813;1122021
2022;4;Oberösterreich;25051289;6459984;18591305;698194
2022;5;Salzburg;10843361;3168319;7675042;302211
2022;6;Steiermark;21677877;6165944;15511933;604175
2022;7;Tirol;9765314;4020480;5744834;272165
2022;8;Vorarlberg;7173127;1595382;5577745;199919
2022;9;Wien;69173992;61532309;7641683;1927920
2022;10;Österreich;196258938;101165341;95093597;5469852
2022;1;Burgenland;5562089;1970921;3591168;155019
2022;2;Kärnten;6756605;1610399;5146206;188311
2022;3;Niederösterreich;40261240;14647195;25614045;1122105
2022;4;Oberösterreich;25053919;6461646;18592273;698268
2022;5;Salzburg;10844460;3169261;7675199;302241
2022;6;Steiermark;21685453;6173042;15512411;604386
2022;7;Tirol;9768155;4023321;5744834;272244
2022;8;Vorarlberg;7173705;1595756;5577949;199935
2022;9;Wien;69199973;61558099;7641874;1928644
2022;10;Österreich;196305599;101209640;95095959;5471153
2022;1;Burgenland;5563966;1972632;3591334;155071
2022;2;Kärnten;6757519;1610992;5146527;188336
2022;3;Niederösterreich;40264193;14649970;25614223;1122187
2022;4;Oberösterreich;25056272;6463102;18593170;698333
2022;5;Salzburg;10845519;3169947;7675572;302271
2022;6;Steiermark;21689657;6176540;15513117;604504
2022;7;Tirol;9769337;4024503;5744834;272277
2022;8;Vorarlberg;7174294;1596091;5578203;199952
2022;9;Wien;69225161;61582992;7642169;1929346
2022;10;Österreich;196345918;101246769;95099149;5472277
2022;1;Burgenland;5566405;1974723;3591682;155139
2022;2;Kärnten;6765111;1613560;5151551;188548
2022;3;Niederösterreich;40269515;14653534;25615981;1122335
2022;4;Oberösterreich;25066943;6465975;18600968;698630
2022;5;Salzburg;10853816;3171262;7682554;302502
2022;6;Steiermark;21693608;6179319;15514289;604614
2022;7;Tirol;9771941;4027107;5744834;272350
2022;8;Vorarlberg;7175133;1596302;5578831;199975
2022;9;Wien;69288724;61646250;7642474;1931118
2022;10;Österreich;196451196;101328032;95123164;5475211
2022;1;Burgenland;5570603;1978625;3591978;155256
2022;2;Kärnten;6767859;1614789;5153070;188624
2022;3;Niederösterreich;40278261;14657670;25620591;1122579
2022;4;Oberösterreich;25073992;6469009;18604983;698827
2022;5;Salzburg;10855542;3172658;7682884;302550
2022;6;Steiermark;21700505;6185386;15515119;604806
2022;7;Tirol;9773761;4028927;5744834;272400
2022;8;Vorarlberg;7176167;1596821;5579346;200004
2022;9;Wien;69332636;61689873;7642763;1932341
2022;10;Österreich;196529326;101393758;95135568;5477388
2022;1;Burgenland;5573539;1981255;3592284;155338
2022;2;Kärnten;6769144;1616074;5153070;188660
2022;3;Niederösterreich;40283892;14661693;25622199;1122736
2022;4;Oberösterreich;25078728;6471215;18607513;698959
2022;5;Salzburg;10856912;3173695;7683217;302589
2022;6;Steiermark;21705455;6189519;15515936;604944
2022;7;Tirol;9775862;4031028;5744834;272459
2022;8;Vorarlberg;7177148;1597243;5579905;200031
2022;9;Wien;69376038;61732975;7643063;1933551
2022;10;Österreich;196596718;101454697;95142021;5479267
2022;1;Burgenland;5577328;1984829;3592499;155443
2022;2;Kärnten;6770032;1616962;5153070;188685
2022;3;Niederösterreich;40288725;14664465;25624260;1122871
2022;4;Oberösterreich;25093204;6474283;18618921;699362
2022;5;Salzburg;10858295;3174742;7683553;302627
2022;6;Steiermark;21710621;6193939;15516682;605088
2022;7;Tirol;9777580;4032746;5744834;272507
2022;8;Vorarlberg;7178115;1597701;5580414;200058
2022;9;Wien;69417086;61773775;7643311;1934695
2022;10;Österreich;196670986;101513442;95157544;5481336
2022;1;Burgenland;5580110;1987455;3592655;155521
2022;2;Kärnten;6770599;1617520;5153079;188701
2022;3;Niederösterreich;40293926;14668667;25625259;1123015
2022;4;Oberösterreich;25097946;6476897;18621049;699495
2022;5;Salzburg;10859468;3175592;7683876;302660
2022;6;Steiermark;21714761;6197394;15517367;605203
2022;7;Tirol;9779409;4034575;5744834;272558
2022;8;Vorarlberg;7178942;1598080;5580862;200081
2022;9;Wien;69445917;61802325;7643592;1935499
2022;10;Österreich;196721078;101558505;95162573;5482733
2022;1;Burgenland;5582015;1989337;3592678;155574
2022;2;Kärnten;6771209;1618130;5153079;188718
2022;3;Niederösterreich;40297986;14672082;25625904;1123129
2022;4;Oberösterreich;25100941;6478601;18622340;699578
2022;5;Salzburg;10860651;3176562;7684089;302693
2022;6;Steiermark;21719810;6202179;15517631;605344
2022;7;Tirol;9781059;4036225;5744834;272604
2022;8;Vorarlberg;7179532;1598470;5581062;200098
2022;9;Wien;69474016;61830214;7643802;1936282
2022;10;Österreich;196767219;101601800;95165419;5484018
2022;1;Burgenland;5583893;1991200;3592693;155626
2022;2;Kärnten;6772028;1618948;5153080;188740
2022;3;Niederösterreich;40301784;14674885;25626899;1123234
2022;4;Oberösterreich;25105140;6480698;18624442;699695
2022;5;Salzburg;10861898;3177556;7684342;302728
2022;6;Steiermark;21721655;6203986;15517669;605395
2022;7;Tirol;9782277;4037443;5744834;272638
2022;8;Vorarlberg;7180047;1598732;5581315;200112
2022;9;Wien;69499103;61855028;7644075;1936981
2022;10;Österreich;196807825;101638476;95169349;5485150
2022;1;Burgenland;5588622;1993862;3594760;155758
2022;2;Kärnten;6777447;1621157;5156290;188891
2022;3;Niederösterreich;40309711;14679030;25630681;1123455
2022;4;Oberösterreich;25115509;6483602;18631907;699984
2022;5;Salzburg;10863657;3178902;7684755;302777
2022;6;Steiermark;21725814;6206904;15518910;605511
2022;7;Tirol;9785516;4040682;5744834;272728
2022;8;Vorarlberg;7181260;1599085;5582175;200146
2022;9;Wien;69555506;61911132;7644374;1938553
2022;10;Österreich;196903042;101714356;95188686;5487804
2022;1;Burgenland;5591999;1997172;3594827;155852
2022;2;Kärnten;6779201;1622631;5156570;188940
2022;3;Niederösterreich;40314412;14682096;25632316;1123586
2022;4;Oberösterreich;25123016;6486660;18636356;700193
2022;5;Salzburg;10865816;3180668;7685148;302837
2022;6;Steiermark;21733617;6213821;15519796;605729
2022;7;Tirol;9788123;4043289;5744834;272801
2022;8;Vorarlberg;7182520;1599776;5582744;200181
2022;9;Wien;69602443;61957751;7644692;1939861
2022;10;Österreich;196981147;101783864;95197283;5489981
2022;1;Burgenland;5596096;2000083;3596013;155966
2022;2;Kärnten;6782496;1623972;5158524;189032
2022;3;Niederösterreich;40321426;14687631;25633795;1123782
2022;4;Oberösterreich;25137249;6489316;18647933;700590
2022;5;Salzburg;10867597;3182070;7685527;302886
2022;6;Steiermark;21769457;6218908;15550549;606728
2022;7;Tirol;9790730;4045896;5744834;272873
2022;8;Vorarlberg;7183926;1600426;5583500;200220
2022;9;Wien;69646823;62001860;7644963;1941098
2022;10;Österreich;197095800;101850162;95245638;5493176
2022;1;Burgenland;5598849;2002802;3596047;156043
2022;2;Kärnten;6783790;1625266;5158524;189068
2022;3;Niederösterreich;40325229;14690367;25634862;1123888
2022;4;Oberösterreich;25143144;6492459;18650685;700754
2022;5;Salzburg;10869459;3183556;7685903;302938
2022;6;Steiermark;21775843;6223884;15551959;606906
2022;7;Tirol;9793207;4048373;5744834;272942
2022;8;Vorarlberg;7185129;1601050;5584079;200254
2022;9;Wien;69692111;62046887;7645224;1942360
2022;10;Österreich;197166761;101914644;95252117;5495154
2022;1;Burgenland;5602873;2005518;3597355;156155
2022;2;Kärnten;6784505;1625974;5158531;189088
2022;3;Niederösterreich;40330821;14694958;25635863;1124044
2022;4;Oberösterreich;25149940;6497160;18652780;700944
2022;5;Salzburg;10871233;3184995;7686238;302988
2022;6;Steiermark;21781753;6228652;15553101;607070
2022;7;Tirol;9795635;4050801;5744834;273010
2022;8;Vorarlberg;7186330;1601764;5584566;200287
2022;9;Wien;69729666;62084129;7645537;1943407
2022;10;Österreich;197232756;101973951;95258805;5496993
2022;1;Burgenland;5605702;2008310;3597392;156234
2022;2;Kärnten;6785353;1626822;5158531;189112
2022;3;Niederösterreich;40335663;14699567;25636096;1124179
2022;4;Oberösterreich;25153607;6499706;18653901;701046
2022;5;Salzburg;10872653;3186215;7686438;303027
2022;6;Steiermark;21787165;6233621;15553544;607221
2022;7;Tirol;9798067;4053233;5744834;273078
2022;8;Vorarlberg;7187316;1602498;5584818;200315
2022;9;Wien;69755967;62110171;7645796;1944140
2022;10;Österreich;197281493;102020143;95261350;5498352
2022;1;Burgenland;5607391;2009979;3597412;156281
2022;2;Kärnten;6787141;1628215;5158926;189162
2022;3;Niederösterreich;40339179;14702785;25636394;1124277
2022;4;Oberösterreich;25157956;6501962;18655994;701167
2022;5;Salzburg;10874122;3187377;7686745;303068
2022;6;Steiermark;21790419;6236317;15554102;607312
2022;7;Tirol;9800155;4055321;5744834;273136
2022;8;Vorarlberg;7188104;1603016;5585088;200337
2022;9;Wien;69786143;62140049;7646094;1944981
2022;10;Österreich;197330610;102065021;95265589;5499721
2022;1;Burgenland;5610599;2013166;3597433;156371
2022;2;Kärnten;6790624;1630601;5160023;189259
2022;3;Niederösterreich;40344953;14707239;25637714;1124438
2022;4;Oberösterreich;25166442;6505569;18660873;701404
2022;5;Salzburg;10883902;3189441;7694461;303341
2022;6;Steiermark;21796258;6240037;15556221;607475
2022;7;Tirol;9804947;4060113;5744834;273270
2022;8;Vorarlberg;7189769;1603565;5586204;200383
2022;9;Wien;69848262;62201804;7646458;1946712
2022;10;Österreich;197435756;102151535;95284221;5502651
2022;1;Burgenland;5614541;2017062;3597479;156481
2022;2;Kärnten;6792678;1632170;5160508;189316
2022;3;Niederösterreich;40353732;14712425;25641307;1124682
2022;4;Oberösterreich;25175867;6510092;18665775;701666
2022;5;Salzburg;10886766;3191849;7694917;303421
2022;6;Steiermark;21816573;6248672;15567901;608041
2022;7;Tirol;9809009;4064175;5744834;273383
2022;8;Vorarlberg;7191687;1604721;5586966;200437
2022;9;Wien;69902908;62256152;7646756;1948235
2022;10;Österreich;197543761;102237318;95306443;5505661
2022;1;Burgenland;5617242;2019700;3597542;156556
2022;2;Kärnten;6795098;1634375;5160723;189383
2022;3;Niederösterreich;40360553;14717247;25643306;1124872
2022;4;Oberösterreich;25196137;6513476;18682661;702231
2022;5;Salzburg;10889441;3194113;7695328;303495
2022;6;Steiermark;21824326;6254868;15569458;608257
2022;7;Tirol;9812991;4068157;5744834;273494
2022;8;Vorarlberg;7193385;1605688;5587697;200484
2022;9;Wien;69953392;62306319;7647073;1949642
2022;10;Österreich;197642565;102313943;95328622;5508415
2022;1;Burgenland;5619894;2022304;3597590;156630
2022;2;Kärnten;6797393;1636076;5161317;189447
2022;3;Niederösterreich;40365728;14720988;25644740;1125017
2022;4;Oberösterreich;25204290;6518592;18685698;702458
2022;5;Salzburg;10891623;3195881;7695742;303556
2022;6;Steiermark;21848089;6260932;15587157;608919
2022;7;Tirol;9816720;4071886;5744834;273598
2022;8;Vorarlberg;7195124;1606673;5588451;200532
2022;9;Wien;70007091;62359722;7647369;1951139
2022;10;Österreich;197745952;102393054;95352898;5511296
2022;1;Burgenland;5619894;2022304;3597590;156630
2022;2;Kärnten;6797393;1636076;5161317;189447
2022;3;Niederösterreich;40365728;14720988;25644740;1125017
2022;4;Oberösterreich;25204290;6518592;18685698;702458
2022;5;Salzburg;10891623;3195881;7695742;303556
2022;6;Steiermark;21848089;6260932;15587157;608919
2022;7;Tirol;9816720;4071886;5744834;273598
2022;8;Vorarlberg;7195124;1606673;5588451;200532
2022;9;Wien;70007091;62359722;7647369;1951139
2022;10;Österreich;197745952;102393054;95352898;5511296
2022;1;Burgenland;5619894;2022304;3597590;156630
2022;2;Kärnten;6797393;1636076;5161317;189447
2022;3;Niederösterreich;40365728;14720988;25644740;1125017
2022;4;Oberösterreich;25204290;6518592;18685698;702458
2022;5;Salzburg;10891623;3195881;7695742;303556
2022;6;Steiermark;21848089;6260932;15587157;608919
2022;7;Tirol;9816720;4071886;5744834;273598
2022;8;Vorarlberg;7195124;1606673;5588451;200532
2022;9;Wien;70007091;62359722;7647369;1951139
2022;10;Österreich;197745952;102393054;95352898;5511296
2022;1;Burgenland;5623848;2026202;3597646;156740
2022;2;Kärnten;6802369;1639089;5163280;189586
2022;3;Niederösterreich;40383049;14735414;25647635;1125499
2022;4;Oberösterreich;25221971;6530267;18691704;702951
2022;5;Salzburg;10896616;3199975;7696641;303695
2022;6;Steiermark;21850790;6277244;15573546;608994
2022;7;Tirol;9826748;4081914;5744834;273877
2022;8;Vorarlberg;7199083;1609349;5589734;200643
2022;9;Wien;70113805;62465483;7648322;1954113
2022;10;Österreich;197918279;102564937;95353342;5516099
2022;1;Burgenland;5630278;2031582;3598696;156919
2022;2;Kärnten;6806376;1641961;5164415;189698
2022;3;Niederösterreich;40391175;14740914;25650261;1125726
2022;4;Oberösterreich;25236150;6535261;18700889;703346
2022;5;Salzburg;10908374;3203474;7704900;304023
2022;6;Steiermark;21857078;6281281;15575797;609170
2022;7;Tirol;9833235;4088401;5744834;274058
2022;8;Vorarlberg;7200913;1610096;5590817;200694
2022;9;Wien;70183504;62534818;7648686;1956056
2022;10;Österreich;198047083;102667788;95379295;5519689
2022;1;Burgenland;5636865;2038121;3598744;157103
2022;2;Kärnten;6809861;1643864;5165997;189795
2022;3;Niederösterreich;40403671;14748593;25655078;1126074
2022;4;Oberösterreich;25245688;6540271;18705417;703612
2022;5;Salzburg;10911700;3206382;7705318;304116
2022;6;Steiermark;21882743;6292327;15590416;609885
2022;7;Tirol;9838337;4093503;5744834;274200
2022;8;Vorarlberg;7203436;1611654;5591782;200764
2022;9;Wien;70239923;62590935;7648988;1957628
2022;10;Österreich;198172224;102765650;95406574;5523177
2022;1;Burgenland;5653121;2042122;3610999;157556
2022;2;Kärnten;6812686;1645832;5166854;189874
2022;3;Niederösterreich;40410766;14754175;25656591;1126272
2022;4;Oberösterreich;25262646;6544120;18718526;704085
2022;5;Salzburg;10915236;3209496;7705740;304214
2022;6;Steiermark;21891743;6299624;15592119;610136
2022;7;Tirol;9843373;4098539;5744834;274341
2022;8;Vorarlberg;7205431;1612827;5592604;200820
2022;9;Wien;70295152;62645755;7649397;1959167
2022;10;Österreich;198290154;102852490;95437664;5526464
2022;1;Burgenland;5655934;2044880;3611054;157634
2022;2;Kärnten;6815552;1647227;5168325;189953
2022;3;Niederösterreich;40416872;14758790;25658082;1126442
2022;4;Oberösterreich;25270898;6549121;18721777;704315
2022;5;Salzburg;10917530;3211416;7706114;304278
2022;6;Steiermark;21900871;6307111;15593760;610390
2022;7;Tirol;9847909;4103075;5744834;274467
2022;8;Vorarlberg;7207418;1614014;5593404;200875
2022;9;Wien;70356065;62706337;7649728;1960865
2022;10;Österreich;198389049;102941971;95447078;5529220
2022;1;Burgenland;5655934;2044880;3611054;157634
2022;2;Kärnten;6815552;1647227;5168325;189953
2022;3;Niederösterreich;40416872;14758790;25658082;1126442
2022;4;Oberösterreich;25270898;6549121;18721777;704315
2022;5;Salzburg;10917530;3211416;7706114;304278
2022;6;Steiermark;21900871;6307111;15593760;610390
2022;7;Tirol;9847909;4103075;5744834;274467
2022;8;Vorarlberg;7207418;1614014;5593404;200875
2022;9;Wien;70356065;62706337;7649728;1960865
2022;10;Österreich;198389049;102941971;95447078;5529220
2022;1;Burgenland;5655934;2044880;3611054;157634
2022;2;Kärnten;6815552;1647227;5168325;189953
2022;3;Niederösterreich;40416872;14758790;25658082;1126442
2022;4;Oberösterreich;25270898;6549121;18721777;704315
2022;5;Salzburg;10917530;3211416;7706114;304278
2022;6;Steiermark;21900871;6307111;15593760;610390
2022;7;Tirol;9847909;4103075;5744834;274467
2022;8;Vorarlberg;7207418;1614014;5593404;200875
2022;9;Wien;70356065;62706337;7649728;1960865
2022;10;Österreich;198389049;102941971;95447078;5529220
2022;1;Burgenland;5661230;2049529;3611701;157782
2022;2;Kärnten;6819487;1651109;5168378;190063
2022;3;Niederösterreich;40435199;14775222;25659977;1126953
2022;4;Oberösterreich;25288424;6560766;18727658;704803
2022;5;Salzburg;10924523;3217510;7707013;304473
2022;6;Steiermark;21921888;6325565;15596323;610976
2022;7;Tirol;9859292;4114458;5744834;274784
2022;8;Vorarlberg;7211545;1616878;5594667;200990
2022;9;Wien;70475175;62824451;7650724;1964185
2022;10;Österreich;198596763;103135488;95461275;5535009
2022;1;Burgenland;5668784;2057061;3611723;157992
2022;2;Kärnten;6825551;1654450;5171101;190232
2022;3;Niederösterreich;40443415;14781391;25662024;1127182
2022;4;Oberösterreich;25320690;6565653;18755037;705703
2022;5;Salzburg;10935962;3220354;7715608;304792
2022;6;Steiermark;21928921;6330301;15598620;611172
2022;7;Tirol;9863377;4118543;5744834;274898
2022;8;Vorarlberg;7213522;1617716;5595806;201045
2022;9;Wien;70541964;62890824;7651140;1966046
2022;10;Österreich;198742186;103236293;95505893;5539062
2022;1;Burgenland;5673501;2061735;3611766;158124
2022;2;Kärnten;6829781;1656476;5173305;190350
2022;3;Niederösterreich;40452426;14788399;25664027;1127433
2022;4;Oberösterreich;25330999;6570130;18760869;705990
2022;5;Salzburg;10939513;3223427;7716086;304891
2022;6;Steiermark;21955639;6342195;15613444;611917
2022;7;Tirol;9872696;4127862;5744834;275158
2022;8;Vorarlberg;7216054;1619350;5596704;201116
2022;9;Wien;70604066;62952566;7651500;1967777
2022;10;Österreich;198874675;103342140;95532535;5542755
2022;1;Burgenland;5678142;2066343;3611799;158253
2022;2;Kärnten;6832747;1658743;5174004;190433
2022;3;Niederösterreich;40461403;14795502;25665901;1127683
2022;4;Oberösterreich;25338057;6573669;18764388;706187
2022;5;Salzburg;10942463;3225931;7716532;304973
2022;6;Steiermark;21965287;6350173;15615114;612186
2022;7;Tirol;9875518;4130684;5744834;275237
2022;8;Vorarlberg;7218056;1620551;5597505;201171
2022;9;Wien;70660485;63008592;7651893;1969349
2022;10;Österreich;198972158;103430188;95541970;5545471
2022;1;Burgenland;5682935;2070065;3612870;158387
2022;2;Kärnten;6834285;1660281;5174004;190476
2022;3;Niederösterreich;40469007;14801235;25667772;1127895
2022;4;Oberösterreich;25361541;6578847;18782694;706841
2022;5;Salzburg;10945142;3228198;7716944;305048
2022;6;Steiermark;21974832;6358077;15616755;612452
2022;7;Tirol;9768953;4024119;5744834;272266
2022;8;Vorarlberg;7219814;1621629;5598185;201220
2022;9;Wien;70713087;63060855;7652232;1970815
2022;10;Österreich;198969596;103403306;95566290;5545400
2022;1;Burgenland;5682935;2070065;3612870;158387
2022;2;Kärnten;6834285;1660281;5174004;190476
2022;3;Niederösterreich;40469007;14801235;25667772;1127895
2022;4;Oberösterreich;25361541;6578847;18782694;706841
2022;5;Salzburg;10945142;3228198;7716944;305048
2022;6;Steiermark;21974832;6358077;15616755;612452
2022;7;Tirol;9768953;4024119;5744834;272266
2022;8;Vorarlberg;7219814;1621629;5598185;201220
2022;9;Wien;70713087;63060855;7652232;1970815
2022;10;Österreich;198969596;103403306;95566290;5545400
2022;1;Burgenland;5682935;2070065;3612870;158387
2022;2;Kärnten;6834285;1660281;5174004;190476
2022;3;Niederösterreich;40469007;14801235;25667772;1127895
2022;4;Oberösterreich;25361541;6578847;18782694;706841
2022;5;Salzburg;10945142;3228198;7716944;305048
2022;6;Steiermark;21974832;6358077;15616755;612452
2022;7;Tirol;9768953;4024119;5744834;272266
2022;8;Vorarlberg;7219814;1621629;5598185;201220
2022;9;Wien;70713087;63060855;7652232;1970815
2022;10;Österreich;198969596;103403306;95566290;5545400
2022;1;Burgenland;5689295;2076176;3613119;158564
2022;2;Kärnten;6837667;1663451;5174216;190570
2022;3;Niederösterreich;40492348;14818572;25673776;1128546
2022;4;Oberösterreich;25378307;6589673;18788634;707308
2022;5;Salzburg;10950886;3233040;7717846;305208
2022;6;Steiermark;21996701;6377380;15619321;613061
2022;7;Tirol;9777931;4033097;5744834;272517
2022;8;Vorarlberg;7223759;1624178;5599581;201330
2022;9;Wien;70838601;63185378;7653223;1974314
2022;10;Österreich;199185495;103600945;95584550;5551417
2022;1;Burgenland;5695221;2082077;3613144;158729
2022;2;Kärnten;6841145;1666078;5175067;190667
2022;3;Niederösterreich;40502447;14825331;25677116;1128827
2022;4;Oberösterreich;25385082;6593791;18791291;707497
2022;5;Salzburg;10970370;3235746;7734624;305751
2022;6;Steiermark;22003551;6381975;15621576;613252
2022;7;Tirol;9782814;4037980;5744834;272653
2022;8;Vorarlberg;7225715;1624812;5600903;201385
2022;9;Wien;70902185;63248608;7653577;1976086
2022;10;Österreich;199308530;103696398;95612132;5554846
2022;1;Burgenland;5702077;2087155;3614922;158920
2022;2;Kärnten;6845396;1667416;5177980;190785
2022;3;Niederösterreich;40512762;14832217;25680545;1129115
2022;4;Oberösterreich;25395498;6597557;18797941;707788
2022;5;Salzburg;10972938;3237891;7735047;305822
2022;6;Steiermark;22037844;6392804;15645040;614208
2022;7;Tirol;9786865;4042031;5744834;272766
2022;8;Vorarlberg;7228157;1626116;5602041;201453
2022;9;Wien;70953923;63300038;7653885;1977528
2022;10;Österreich;199435460;103783225;95652235;5558384
2022;1;Burgenland;5705873;2090909;3614964;159026
2022;2;Kärnten;6846963;1668918;5178045;190829
2022;3;Niederösterreich;40521028;14838313;25682715;1129345
2022;4;Oberösterreich;25417085;6600604;18816481;708389
2022;5;Salzburg;10975499;3240039;7735460;305894
2022;6;Steiermark;22046688;6400064;15646624;614454
2022;7;Tirol;9790130;4045296;5744834;272857
2022;8;Vorarlberg;7230092;1626960;5603132;201507
2022;9;Wien;71006926;63352702;7654224;1979005
2022;10;Österreich;199540284;103863805;95676479;5561305
2022;1;Burgenland;5709088;2094082;3615006;159116
2022;2;Kärnten;6848465;1670420;5178045;190871
2022;3;Niederösterreich;40530881;14843385;25687496;1129620
2022;4;Oberösterreich;25424561;6604677;18819884;708598
2022;5;Salzburg;10977332;3241482;7735850;305945
2022;6;Steiermark;22054897;6406780;15648117;614683
2022;7;Tirol;9792826;4047992;5744834;272932
2022;8;Vorarlberg;7231843;1627847;5603996;201556
2022;9;Wien;71055481;63400953;7654528;1980358
2022;10;Österreich;199625374;103937618;95687756;5563677
2022;1;Burgenland;5709088;2094082;3615006;159116
2022;2;Kärnten;6848465;1670420;5178045;190871
2022;3;Niederösterreich;40530881;14843385;25687496;1129620
2022;4;Oberösterreich;25424561;6604677;18819884;708598
2022;5;Salzburg;10977332;3241482;7735850;305945
2022;6;Steiermark;22054897;6406780;15648117;614683
2022;7;Tirol;9792826;4047992;5744834;272932
2022;8;Vorarlberg;7231843;1627847;5603996;201556
2022;9;Wien;71055481;63400953;7654528;1980358
2022;10;Österreich;199625374;103937618;95687756;5563677
2022;1;Burgenland;5709088;2094082;3615006;159116
2022;2;Kärnten;6848465;1670420;5178045;190871
2022;3;Niederösterreich;40530881;14843385;25687496;1129620
2022;4;Oberösterreich;25424561;6604677;18819884;708598
2022;5;Salzburg;10977332;3241482;7735850;305945
2022;6;Steiermark;22054897;6406780;15648117;614683
2022;7;Tirol;9792826;4047992;5744834;272932
2022;8;Vorarlberg;7231843;1627847;5603996;201556
2022;9;Wien;71055481;63400953;7654528;1980358
2022;10;Österreich;199625374;103937618;95687756;5563677
2022;1;Burgenland;5718394;2102756;3615638;159375
2022;2;Kärnten;6851377;1673070;5178307;190952
2022;3;Niederösterreich;40548332;14858190;25690142;1130106
2022;4;Oberösterreich;25438220;6612551;18825669;708978
2022;5;Salzburg;10982030;3245314;7736716;306076
2022;6;Steiermark;22072748;6422280;15650468;615181
2022;7;Tirol;9799038;4054204;5744834;273105
2022;8;Vorarlberg;7235038;1629792;5605246;201645
2022;9;Wien;71153116;63497826;7655290;1983079
2022;10;Österreich;199798293;104095983;95702310;5568496
2022;1;Burgenland;5720693;2103155;3617538;159439
2022;2;Kärnten;6856495;1674936;5181559;191095
2022;3;Niederösterreich;40556504;14863653;25692851;1130334
2022;4;Oberösterreich;25446058;6615527;18830531;709197
2022;5;Salzburg;10992171;3247311;7744860;306358
2022;6;Steiermark;22078151;6425597;15652554;615331
2022;7;Tirol;9803711;4058877;5744834;273235
2022;8;Vorarlberg;7236550;1630232;5606318;201687
2022;9;Wien;71207950;63552322;7655628;1984608
2022;10;Österreich;199898283;104171610;95726673;5571283
2022;1;Burgenland;5720693;2103155;3617538;159439
2022;2;Kärnten;6856495;1674936;5181559;191095
2022;3;Niederösterreich;40556504;14863653;25692851;1130334
2022;4;Oberösterreich;25446058;6615527;18830531;709197
2022;5;Salzburg;10992171;3247311;7744860;306358
2022;6;Steiermark;22078151;6425597;15652554;615331
2022;7;Tirol;9803711;4058877;5744834;273235
2022;8;Vorarlberg;7236550;1630232;5606318;201687
2022;9;Wien;71207950;63552322;7655628;1984608
2022;10;Österreich;199898283;104171610;95726673;5571283
2022;1;Burgenland;5724407;2105882;3618525;159543
2022;2;Kärnten;6859956;1676956;5183000;191191
2022;3;Niederösterreich;40573635;14874868;25698767;1130811
2022;4;Oberösterreich;25469243;6619870;18849373;709843
2022;5;Salzburg;10995012;3249588;7745424;306437
2022;6;Steiermark;22107619;6438567;15669052;616152
2022;7;Tirol;9810473;4065639;5744834;273424
2022;8;Vorarlberg;7238959;1631657;5607302;201754
2022;9;Wien;71288765;63632640;7656125;1986860
2022;10;Österreich;200068069;104295667;95772402;5576015
2022;1;Burgenland;5728269;2109709;3618560;159650
2022;2;Kärnten;6861809;1678330;5183479;191243
2022;3;Niederösterreich;40578127;14877854;25700273;1130936
2022;4;Oberösterreich;25473165;6623297;18849868;709952
2022;5;Salzburg;10996810;3251027;7745783;306488
2022;6;Steiermark;22111644;6440946;15670698;616265
2022;7;Tirol;9813770;4068936;5744834;273516
2022;8;Vorarlberg;7239821;1631921;5607900;201778
2022;9;Wien;71324443;63668024;7656419;1987854
2022;10;Österreich;200127858;104350044;95777814;5577681
2022;1;Burgenland;5728269;2109709;3618560;159650
2022;2;Kärnten;6861809;1678330;5183479;191243
2022;3;Niederösterreich;40578127;14877854;25700273;1130936
2022;4;Oberösterreich;25473165;6623297;18849868;709952
2022;5;Salzburg;10996810;3251027;7745783;306488
2022;6;Steiermark;22111644;6440946;15670698;616265
2022;7;Tirol;9813770;4068936;5744834;273516
2022;8;Vorarlberg;7239821;1631921;5607900;201778
2022;9;Wien;71324443;63668024;7656419;1987854
2022;10;Österreich;200127858;104350044;95777814;5577681
2022;1;Burgenland;5728269;2109709;3618560;159650
2022;2;Kärnten;6861809;1678330;5183479;191243
2022;3;Niederösterreich;40578127;14877854;25700273;1130936
2022;4;Oberösterreich;25473165;6623297;18849868;709952
2022;5;Salzburg;10996810;3251027;7745783;306488
2022;6;Steiermark;22111644;6440946;15670698;616265
2022;7;Tirol;9813770;4068936;5744834;273516
2022;8;Vorarlberg;7239821;1631921;5607900;201778
2022;9;Wien;71324443;63668024;7656419;1987854
2022;10;Österreich;200127858;104350044;95777814;5577681
2022;1;Burgenland;5732180;2112329;3619851;159759
2022;2;Kärnten;6864712;1680348;5184364;191324
2022;3;Niederösterreich;40593221;14891035;25702186;1131357
2022;4;Oberösterreich;25483847;6628922;18854925;710250
2022;5;Salzburg;11005590;3253732;7751858;306732
2022;6;Steiermark;22126227;6453491;15672736;616671
2022;7;Tirol;9819068;4074234;5744834;273663
2022;8;Vorarlberg;7242331;1633323;5609008;201848
2022;9;Wien;71388825;63731974;7656851;1989649
2022;10;Österreich;200256001;104459388;95796613;5581253
2022;1;Burgenland;5732180;2112329;3619851;159759
2022;2;Kärnten;6864712;1680348;5184364;191324
2022;3;Niederösterreich;40593221;14891035;25702186;1131357
2022;4;Oberösterreich;25483847;6628922;18854925;710250
2022;5;Salzburg;11005590;3253732;7751858;306732
2022;6;Steiermark;22126227;6453491;15672736;616671
2022;7;Tirol;9819068;4074234;5744834;273663
2022;8;Vorarlberg;7242331;1633323;5609008;201848
2022;9;Wien;71388825;63731974;7656851;1989649
2022;10;Österreich;200256001;104459388;95796613;5581253
2022;1;Burgenland;5732241;2112329;3619912;159761
2022;2;Kärnten;6867257;1682063;5185194;191395
2022;3;Niederösterreich;40609699;14901150;25708549;1131816
2022;4;Oberösterreich;25493549;6632571;18860978;710520
2022;5;Salzburg;11008413;3256013;7752400;306811
2022;6;Steiermark;22147515;6462351;15685164;617264
2022;7;Tirol;9823902;4079068;5744834;273798
2022;8;Vorarlberg;7244203;1634166;5610037;201900
2022;9;Wien;71477253;63819583;7657670;1992113
2022;10;Österreich;200404032;104579294;95824738;5585379
2022;1;Burgenland;5743067;2122225;3620842;160063
2022;2;Kärnten;6871869;1684314;5187555;191523
2022;3;Niederösterreich;40615603;14904438;25711165;1131981
2022;4;Oberösterreich;25509970;6634198;18875772;710978
2022;5;Salzburg;11010351;3257538;7752813;306865
2022;6;Steiermark;22152464;6465191;15687273;617402
2022;7;Tirol;9827559;4082725;5744834;273900
2022;8;Vorarlberg;7245469;1634436;5611033;201935
2022;9;Wien;71528206;63870273;7657933;1993533
2022;10;Österreich;200504558;104655338;95849220;5588180
2022;1;Burgenland;5745674;2124814;3620860;160135
2022;2;Kärnten;6874144;1685264;5188880;191586
2022;3;Niederösterreich;40621040;14907873;25713167;1132132
2022;4;Oberösterreich;25515997;6637147;18878850;711146
2022;5;Salzburg;11011785;3258590;7753195;306905
2022;6;Steiermark;22159789;6470860;15688929;617606
2022;7;Tirol;9829754;4084920;5744834;273961
2022;8;Vorarlberg;7246717;1634981;5611736;201970
2022;9;Wien;71573083;63914924;7658159;1994784
2022;10;Österreich;200577983;104719373;95858610;5590227
2022;1;Burgenland;5745674;2124814;3620860;160135
2022;2;Kärnten;6874144;1685264;5188880;191586
2022;3;Niederösterreich;40621040;14907873;25713167;1132132
2022;4;Oberösterreich;25515997;6637147;18878850;711146
2022;5;Salzburg;11011785;3258590;7753195;306905
2022;6;Steiermark;22159789;6470860;15688929;617606
2022;7;Tirol;9829754;4084920;5744834;273961
2022;8;Vorarlberg;7246717;1634981;5611736;201970
2022;9;Wien;71573083;63914924;7658159;1994784
2022;10;Österreich;200577983;104719373;95858610;5590227
2022;1;Burgenland;5745674;2124814;3620860;160135
2022;2;Kärnten;6874144;1685264;5188880;191586
2022;3;Niederösterreich;40621040;14907873;25713167;1132132
2022;4;Oberösterreich;25515997;6637147;18878850;711146
2022;5;Salzburg;11011785;3258590;7753195;306905
2022;6;Steiermark;22159789;6470860;15688929;617606
2022;7;Tirol;9829754;4084920;5744834;273961
2022;8;Vorarlberg;7246717;1634981;5611736;201970
2022;9;Wien;71573083;63914924;7658159;1994784
2022;10;Österreich;200577983;104719373;95858610;5590227
2022;1;Burgenland;5751741;2128990;3622751;160304
2022;2;Kärnten;6876822;1687456;5189366;191661
2022;3;Niederösterreich;40636909;14921183;25715726;1132575
2022;4;Oberösterreich;25527643;6642742;18884901;711470
2022;5;Salzburg;11014214;3260313;7753901;306973
2022;6;Steiermark;22173235;6481951;15691284;617981
2022;7;Tirol;9834756;4089922;5744834;274100
2022;8;Vorarlberg;7248886;1636034;5612852;202031
2022;9;Wien;71656558;63997794;7658764;1997111
2022;10;Österreich;200720764;104846385;95874379;5594206
2022;1;Burgenland;5759330;2136579;3622751;160516
2022;2;Kärnten;6880155;1689470;5190685;191754
2022;3;Niederösterreich;40643998;14925473;25718525;1132772
2022;4;Oberösterreich;25533899;6645010;18888889;711645
2022;5;Salzburg;11023419;3262634;7760785;307229
2022;6;Steiermark;22177936;6484561;15693375;618112
2022;7;Tirol;9838299;4093465;5744834;274199
2022;8;Vorarlberg;7249947;1636273;5613674;202060
2022;9;Wien;71709195;64050173;7659022;1998578
2022;10;Österreich;200816178;104923638;95892540;5596865
2022;1;Burgenland;5763985;2140126;3623859;160646
2022;2;Kärnten;6881828;1690390;5191438;191801
2022;3;Niederösterreich;40655681;14930613;25725068;1133098
2022;4;Oberösterreich;25540399;6647017;18893382;711826
2022;5;Salzburg;11025090;3263939;7761151;307276
2022;6;Steiermark;22201171;6491273;15709898;618760
2022;7;Tirol;9839351;4094517;5744834;274229
2022;8;Vorarlberg;7251261;1636858;5614403;202097
2022;9;Wien;71752241;64092975;7659266;1999777
2022;10;Österreich;200911007;104987708;95923299;5599508
2022;1;Burgenland;5766760;2142886;3623874;160723
2022;2;Kärnten;6884126;1691524;5192602;191865
2022;3;Niederösterreich;40662720;14934919;25727801;1133294
2022;4;Oberösterreich;25545355;6648758;18896597;711964
2022;5;Salzburg;11026519;3265024;7761495;307316
2022;6;Steiermark;22220132;6495727;15724405;619288
2022;7;Tirol;10391945;4647111;5744834;289630
2022;8;Vorarlberg;7252427;1637241;5615186;202129
2022;9;Wien;71793049;64133587;7659462;2000915
2022;10;Österreich;201543033;105596777;95946256;5617123
2022;1;Burgenland;5769760;2145871;3623889;160807
2022;2;Kärnten;6884846;1692244;5192602;191885
2022;3;Niederösterreich;40669665;14939247;25730418;1133488
2022;4;Oberösterreich;25551110;6651501;18899609;712125
2022;5;Salzburg;11027944;3266120;7761824;307355
2022;6;Steiermark;22226141;6500201;15725940;619456
2022;7;Tirol;10393956;4649122;5744834;289686
2022;8;Vorarlberg;7253426;1637612;5615814;202157
2022;9;Wien;71831271;64171508;7659763;2001980
2022;10;Österreich;201608119;105653426;95954693;5618937
2022;1;Burgenland;5769760;2145871;3623889;160807
2022;2;Kärnten;6884846;1692244;5192602;191885
2022;3;Niederösterreich;40669665;14939247;25730418;1133488
2022;4;Oberösterreich;25551110;6651501;18899609;712125
2022;5;Salzburg;11027944;3266120;7761824;307355
2022;6;Steiermark;22226141;6500201;15725940;619456
2022;7;Tirol;10393956;4649122;5744834;289686
2022;8;Vorarlberg;7253426;1637612;5615814;202157
2022;9;Wien;71831271;64171508;7659763;2001980
2022;10;Österreich;201608119;105653426;95954693;5618937
2022;1;Burgenland;5769760;2145871;3623889;160807
2022;2;Kärnten;6884846;1692244;5192602;191885
2022;3;Niederösterreich;40669665;14939247;25730418;1133488
2022;4;Oberösterreich;25551110;6651501;18899609;712125
2022;5;Salzburg;11027944;3266120;7761824;307355
2022;6;Steiermark;22226141;6500201;15725940;619456
2022;7;Tirol;10393956;4649122;5744834;289686
2022;8;Vorarlberg;7253426;1637612;5615814;202157
2022;9;Wien;71831271;64171508;7659763;2001980
2022;10;Österreich;201608119;105653426;95954693;5618937
2022;1;Burgenland;5777270;2151926;3625344;161016
2022;2;Kärnten;6886511;1693887;5192624;191931
2022;3;Niederösterreich;40684536;14950830;25733706;1133902
2022;4;Oberösterreich;25561603;6656117;18905486;712417
2022;5;Salzburg;11030946;3268410;7762536;307439
2022;6;Steiermark;22238503;6510099;15728404;619800
2022;7;Tirol;10398488;4653654;5744834;289812
2022;8;Vorarlberg;7255410;1638458;5616952;202213
2022;9;Wien;71916297;64255897;7660400;2004350
2022;10;Österreich;201749564;105779278;95970286;5622879
2022;1;Burgenland;5780339;2154990;3625349;161101
2022;2;Kärnten;6891247;1695774;5195473;192063
2022;3;Niederösterreich;40690743;14954778;25735965;1134075
2022;4;Oberösterreich;25568827;6658574;18910253;712618
2022;5;Salzburg;11039867;3269883;7769984;307688
2022;6;Steiermark;22243226;6512556;15730670;619932
2022;7;Tirol;10402192;4657358;5744834;289915
2022;8;Vorarlberg;7256693;1638679;5618014;202248
2022;9;Wien;71964537;64303880;7660657;2005694
2022;10;Österreich;201837671;105846472;95991199;5625335
2022;1;Burgenland;5785074;2158609;3626465;161233
2022;2;Kärnten;6892604;1696903;5195701;192101
2022;3;Niederösterreich;40697978;14960202;25737776;1134277
2022;4;Oberösterreich;25575958;6660384;18915574;712817
2022;5;Salzburg;11041376;3271036;7770340;307730
2022;6;Steiermark;22260480;6518886;15741594;620413
2022;7;Tirol;10404969;4660135;5744834;289993
2022;8;Vorarlberg;7257956;1639192;5618764;202284
2022;9;Wien;72001978;64341097;7660881;2006738
2022;10;Österreich;201918373;105906444;96011929;5627584
2022;1;Burgenland;5787910;2161405;3626505;161312
2022;2;Kärnten;6894839;1698237;5196602;192163
2022;3;Niederösterreich;40704465;14962734;25741731;1134457
2022;4;Oberösterreich;25608974;6662174;18946800;713737
2022;5;Salzburg;11042910;3272194;7770716;307772
2022;6;Steiermark;22266809;6523436;15743373;620589
2022;7;Tirol;10407435;4662601;5744834;290061
2022;8;Vorarlberg;7259172;1639565;5619607;202317
2022;9;Wien;72049965;64388895;7661070;2008075
2022;10;Österreich;202022479;105971241;96051238;5630486
2022;1;Burgenland;5790750;2164207;3626543;161392
2022;2;Kärnten;6895667;1699065;5196602;192186
2022;3;Niederösterreich;40707738;14965004;25742734;1134549
2022;4;Oberösterreich;25615023;6665042;18949981;713906
2022;5;Salzburg;11044142;3273051;7771091;307807
2022;6;Steiermark;22272692;6527685;15745007;620753
2022;7;Tirol;10409501;4664667;5744834;290119
2022;8;Vorarlberg;7260241;1639951;5620290;202347
2022;9;Wien;72093046;64431762;7661284;2009276
2022;10;Österreich;202088800;106030434;96058366;5632334
2022;1;Burgenland;5790750;2164207;3626543;161392
2022;2;Kärnten;6895667;1699065;5196602;192186
2022;3;Niederösterreich;40707738;14965004;25742734;1134549
2022;4;Oberösterreich;25615023;6665042;18949981;713906
2022;5;Salzburg;11044142;3273051;7771091;307807
2022;6;Steiermark;22272692;6527685;15745007;620753
2022;7;Tirol;10409501;4664667;5744834;290119
2022;8;Vorarlberg;7260241;1639951;5620290;202347
2022;9;Wien;72093046;64431762;7661284;2009276
2022;10;Österreich;202088800;106030434;96058366;5632334
2022;1;Burgenland;5790750;2164207;3626543;161392
2022;2;Kärnten;6895667;1699065;5196602;192186
2022;3;Niederösterreich;40707738;14965004;25742734;1134549
2022;4;Oberösterreich;25615023;6665042;18949981;713906
2022;5;Salzburg;11044142;3273051;7771091;307807
2022;6;Steiermark;22272692;6527685;15745007;620753
2022;7;Tirol;10409501;4664667;5744834;290119
2022;8;Vorarlberg;7260241;1639951;5620290;202347
2022;9;Wien;72093046;64431762;7661284;2009276
2022;10;Österreich;202088800;106030434;96058366;5632334
2022;1;Burgenland;5797219;2169666;3627553;161572
2022;2;Kärnten;6898895;1701268;5197627;192276
2022;3;Niederösterreich;40722616;14977828;25744788;1134963
2022;4;Oberösterreich;25626577;6670055;18956522;714228
2022;5;Salzburg;11047262;3275316;7771946;307894
2022;6;Steiermark;22285582;6537932;15747650;621112
2022;7;Tirol;10414469;4669635;5744834;290257
2022;8;Vorarlberg;7262374;1640853;5621521;202407
2022;9;Wien;72174563;64512657;7661906;2011548
2022;10;Österreich;202229557;106155210;96074347;5636257
2022;1;Burgenland;5799327;2171747;3627580;161631
2022;2;Kärnten;6900641;1703014;5197627;192325
2022;3;Niederösterreich;40728323;14982033;25746290;1135122
2022;4;Oberösterreich;25634797;6672136;18962661;714457
2022;5;Salzburg;11056463;3276895;7779568;308150
2022;6;Steiermark;22290604;6540640;15749964;621252
2022;7;Tirol;10418336;4673502;5744834;290365
2022;8;Vorarlberg;7263679;1641117;5622562;202443
2022;9;Wien;72222191;64560058;7662133;2012875
2022;10;Österreich;202314361;106221142;96093219;5638621
2022;1;Burgenland;5804128;2175641;3628487;161764
2022;2;Kärnten;6902192;1704565;5197627;192368
2022;3;Niederösterreich;40735531;14987235;25748296;1135323
2022;4;Oberösterreich;25643832;6673755;18970077;714709
2022;5;Salzburg;11058044;3278023;7780021;308194
2022;6;Steiermark;22307337;6547235;15760102;621719
2022;7;Tirol;10421058;4676224;5744834;290441
2022;8;Vorarlberg;7265139;1641704;5623435;202484
2022;9;Wien;72272733;64610383;7662350;2014284
2022;10;Österreich;202409994;106294765;96115229;5641286
2022;1;Burgenland;5807071;2178539;3628532;161846
2022;2;Kärnten;6907207;1705575;5201632;192508
2022;3;Niederösterreich;40745021;14991525;25753496;1135588
2022;4;Oberösterreich;25659959;6675769;18984190;715158
2022;5;Salzburg;11059592;3279071;7780521;308237
2022;6;Steiermark;22321808;6551733;15770075;622122
2022;7;Tirol;10423585;4678751;5744834;290511
2022;8;Vorarlberg;7266424;1642146;5624278;202520
2022;9;Wien;72314414;64651835;7662579;2015445
2022;10;Österreich;202505081;106354944;96150137;5643936
2022;1;Burgenland;5813720;2185149;3628571;162032
2022;2;Kärnten;6908505;1706873;5201632;192544
2022;3;Niederösterreich;40749966;14995244;25754722;1135726
2022;4;Oberösterreich;25666309;6678672;18987637;715335
2022;5;Salzburg;11061026;3280026;7781000;308277
2022;6;Steiermark;22327527;6555769;15771758;622281
2022;7;Tirol;10425757;4680923;5744834;290572
2022;8;Vorarlberg;7267612;1642601;5625011;202553
2022;9;Wien;72356144;64693334;7662810;2016608
2022;10;Österreich;202576566;106418591;96157975;5645928
2022;1;Burgenland;5813720;2185149;3628571;162032
2022;2;Kärnten;6908505;1706873;5201632;192544
2022;3;Niederösterreich;40749966;14995244;25754722;1135726
2022;4;Oberösterreich;25666309;6678672;18987637;715335
2022;5;Salzburg;11061026;3280026;7781000;308277
2022;6;Steiermark;22327527;6555769;15771758;622281
2022;7;Tirol;10425757;4680923;5744834;290572
2022;8;Vorarlberg;7267612;1642601;5625011;202553
2022;9;Wien;72356144;64693334;7662810;2016608
2022;10;Österreich;202576566;106418591;96157975;5645928
2022;1;Burgenland;5813720;2185149;3628571;162032
2022;2;Kärnten;6908505;1706873;5201632;192544
2022;3;Niederösterreich;40749966;14995244;25754722;1135726
2022;4;Oberösterreich;25666309;6678672;18987637;715335
2022;5;Salzburg;11061026;3280026;7781000;308277
2022;6;Steiermark;22327527;6555769;15771758;622281
2022;7;Tirol;10425757;4680923;5744834;290572
2022;8;Vorarlberg;7267612;1642601;5625011;202553
2022;9;Wien;72356144;64693334;7662810;2016608
2022;10;Österreich;202576566;106418591;96157975;5645928
2022;1;Burgenland;5820996;2191964;3629032;162235
2022;2;Kärnten;6911502;1708956;5202546;192628
2022;3;Niederösterreich;40763888;15007363;25756525;1136114
2022;4;Oberösterreich;25678005;6683625;18994380;715661
2022;5;Salzburg;11064438;3282329;7782109;308372
2022;6;Steiermark;22341103;6566501;15774602;622660
2022;7;Tirol;10430893;4686059;5744834;290715
2022;8;Vorarlberg;7269939;1643739;5626200;202617
2022;9;Wien;72442793;64779283;7663510;2019023
2022;10;Österreich;202723557;106549819;96173738;5650025
2022;1;Burgenland;5825354;2195221;3630133;162356
2022;2;Kärnten;6913391;1710845;5202546;192680
2022;3;Niederösterreich;40768614;15010917;25757697;1136245
2022;4;Oberösterreich;25688437;6685738;19002699;715952
2022;5;Salzburg;11074175;3283889;7790286;308644
2022;6;Steiermark;22346337;6569174;15777163;622806
2022;7;Tirol;10152808;4407974;5744834;282965
2022;8;Vorarlberg;7271395;1643995;5627400;202658
2022;9;Wien;72494891;64831068;7663823;2020475
2022;10;Österreich;202535402;106338821;96196581;5644781
2022;1;Burgenland;5829910;2198753;3631157;162483
2022;2;Kärnten;6914843;1711878;5202965;192721
2022;3;Niederösterreich;40777670;15015865;25761805;1136498
2022;4;Oberösterreich;25707455;6687683;19019772;716482
2022;5;Salzburg;11075859;3285011;7790848;308691
2022;6;Steiermark;22370292;6576211;15794081;623473
2022;7;Tirol;10155870;4411036;5744834;283050
2022;8;Vorarlberg;7273198;1644682;5628516;202708
2022;9;Wien;72541478;64877430;7664048;2021774
2022;10;Österreich;202646575;106408549;96238026;5647880
2022;1;Burgenland;5832896;2201702;3631194;162566
2022;2;Kärnten;6917567;1713205;5204362;192797
2022;3;Niederösterreich;40783826;15020336;25763490;1136669
2022;4;Oberösterreich;25713160;6689768;19023392;716641
2022;5;Salzburg;11077684;3286275;7791409;308742
2022;6;Steiermark;22377469;6580948;15796521;623673
2022;7;Tirol;10158866;4414032;5744834;283134
2022;8;Vorarlberg;7274684;1645220;5629464;202750
2022;9;Wien;72585231;64920963;7664268;2022993
2022;10;Österreich;202721383;106472449;96248934;5649965
2022;1;Burgenland;5835795;2204559;3631236;162647
2022;2;Kärnten;6918575;1714213;5204362;192825
2022;3;Niederösterreich;40788413;15024127;25764286;1136797
2022;4;Oberösterreich;25719302;6692369;19026933;716812
2022;5;Salzburg;11079239;3287280;7791959;308785
2022;6;Steiermark;22384148;6585792;15798356;623859
2022;7;Tirol;10161276;4416442;5744834;283201
2022;8;Vorarlberg;7276074;1645678;5630396;202788
2022;9;Wien;72628682;64964099;7664583;2024204
2022;10;Österreich;202791504;106534559;96256945;5651919
2022;1;Burgenland;5835795;2204559;3631236;162647
2022;2;Kärnten;6918575;1714213;5204362;192825
2022;3;Niederösterreich;40788413;15024127;25764286;1136797
2022;4;Oberösterreich;25719302;6692369;19026933;716812
2022;5;Salzburg;11079239;3287280;7791959;308785
2022;6;Steiermark;22384148;6585792;15798356;623859
2022;7;Tirol;10161276;4416442;5744834;283201
2022;8;Vorarlberg;7276074;1645678;5630396;202788
2022;9;Wien;72628682;64964099;7664583;2024204
2022;10;Österreich;202791504;106534559;96256945;5651919
2022;1;Burgenland;5835795;2204559;3631236;162647
2022;2;Kärnten;6918575;1714213;5204362;192825
2022;3;Niederösterreich;40788413;15024127;25764286;1136797
2022;4;Oberösterreich;25719302;6692369;19026933;716812
2022;5;Salzburg;11079239;3287280;7791959;308785
2022;6;Steiermark;22384148;6585792;15798356;623859
2022;7;Tirol;10161276;4416442;5744834;283201
2022;8;Vorarlberg;7276074;1645678;5630396;202788
2022;9;Wien;72628682;64964099;7664583;2024204
2022;10;Österreich;202791504;106534559;96256945;5651919
2022;1;Burgenland;5844312;2211463;3632849;162884
2022;2;Kärnten;6921407;1716086;5205321;192904
2022;3;Niederösterreich;40802425;15036659;25765766;1137188
2022;4;Oberösterreich;25729825;6697859;19031966;717105
2022;5;Salzburg;11082991;3289823;7793168;308889
2022;6;Steiermark;22397674;6596131;15801543;624236
2022;7;Tirol;10148505;4403671;5744834;282845
2022;8;Vorarlberg;7278589;1646655;5631934;202859
2022;9;Wien;72722756;65057477;7665279;2026826
2022;10;Österreich;202928484;106655824;96272660;5655737
2022;1;Burgenland;5846451;2213567;3632884;162944
2022;2;Kärnten;6924009;1718473;5205536;192976
2022;3;Niederösterreich;40808498;15040828;25767670;1137357
2022;4;Oberösterreich;25761207;6699892;19061315;717980
2022;5;Salzburg;11092899;3291423;7801476;309166
2022;6;Steiermark;22403069;6598834;15804235;624387
2022;7;Tirol;10170907;4426073;5744834;283469
2022;8;Vorarlberg;7279978;1646925;5633053;202897
2022;9;Wien;72773117;65107495;7665622;2028230
2022;10;Österreich;203060135;106743510;96316625;5659406
2022;1;Burgenland;5851989;2218185;3633804;163098
2022;2;Kärnten;6925483;1719493;5205990;193017
2022;3;Niederösterreich;40818854;15045754;25773100;1137646
2022;4;Oberösterreich;25768850;6701886;19066964;718193
2022;5;Salzburg;11094677;3292588;7802089;309215
2022;6;Steiermark;22426927;6605691;15821236;625052
2022;7;Tirol;10173574;4428740;5744834;283544
2022;8;Vorarlberg;7281425;1647553;5633872;202938
2022;9;Wien;72814657;65148727;7665930;2029387
2022;10;Österreich;203156436;106808617;96347819;5662090
2022;1;Burgenland;5851989;2218185;3633804;163098
2022;2;Kärnten;6925483;1719493;5205990;193017
2022;3;Niederösterreich;40818854;15045754;25773100;1137646
2022;4;Oberösterreich;25768850;6701886;19066964;718193
2022;5;Salzburg;11094677;3292588;7802089;309215
2022;6;Steiermark;22426927;6605691;15821236;625052
2022;7;Tirol;10173574;4428740;5744834;283544
2022;8;Vorarlberg;7281425;1647553;5633872;202938
2022;9;Wien;72814657;65148727;7665930;2029387
2022;10;Österreich;203156436;106808617;96347819;5662090
2022;1;Burgenland;5857787;2223917;3633870;163260
2022;2;Kärnten;6927232;1721139;5206093;193066
2022;3;Niederösterreich;40831297;15053883;25777414;1137992
2022;4;Oberösterreich;25790281;6706198;19084083;718790
2022;5;Salzburg;11097372;3294302;7803070;309290
2022;6;Steiermark;22437302;6613632;15823670;625341
2022;7;Tirol;10177004;4432170;5744834;283639
2022;8;Vorarlberg;7283450;1648412;5635038;202994
2022;9;Wien;72888365;65221969;7666396;2031442
2022;10;Österreich;203290090;106915622;96374468;5665815
2022;1;Burgenland;5857787;2223917;3633870;163260
2022;2;Kärnten;6927232;1721139;5206093;193066
2022;3;Niederösterreich;40831297;15053883;25777414;1137992
2022;4;Oberösterreich;25790281;6706198;19084083;718790
2022;5;Salzburg;11097372;3294302;7803070;309290
2022;6;Steiermark;22437302;6613632;15823670;625341
2022;7;Tirol;10177004;4432170;5744834;283639
2022;8;Vorarlberg;7283450;1648412;5635038;202994
2022;9;Wien;72888365;65221969;7666396;2031442
2022;10;Österreich;203290090;106915622;96374468;5665815
2022;1;Burgenland;5857787;2223917;3633870;163260
2022;2;Kärnten;6927232;1721139;5206093;193066
2022;3;Niederösterreich;40831297;15053883;25777414;1137992
2022;4;Oberösterreich;25790281;6706198;19084083;718790
2022;5;Salzburg;11097372;3294302;7803070;309290
2022;6;Steiermark;22437302;6613632;15823670;625341
2022;7;Tirol;10177004;4432170;5744834;283639
2022;8;Vorarlberg;7283450;1648412;5635038;202994
2022;9;Wien;72888365;65221969;7666396;2031442
2022;10;Österreich;203290090;106915622;96374468;5665815
2022;1;Burgenland;5865106;2229860;3635246;163464
2022;2;Kärnten;6931196;1723523;5207673;193177
2022;3;Niederösterreich;40845585;15064905;25780680;1138391
2022;4;Oberösterreich;25802056;6710547;19091509;719119
2022;5;Salzburg;11101296;3296880;7804416;309400
2022;6;Steiermark;22449397;6622503;15826894;625678
2022;7;Tirol;10182585;4437751;5744834;283795
2022;8;Vorarlberg;7285941;1649400;5636541;203063
2022;9;Wien;72977513;65310374;7667139;2033926
2022;10;Österreich;203440675;107045743;96394932;5670012
2022;1;Burgenland;5868085;2232813;3635272;163547
2022;2;Kärnten;6934218;1725273;5208945;193261
2022;3;Niederösterreich;40850079;15067928;25782151;1138516
2022;4;Oberösterreich;25810923;6713232;19097691;719366
2022;5;Salzburg;11111088;3298299;7812789;309673
2022;6;Steiermark;22465890;6625771;15840119;626138
2022;7;Tirol;10186648;4441814;5744834;283908
2022;8;Vorarlberg;7287498;1649712;5637786;203107
2022;9;Wien;73025608;65358153;7667455;2035267
2022;10;Österreich;203540037;107112995;96427042;5672781
2022;1;Burgenland;5873768;2237477;3636291;163705
2022;2;Kärnten;6935641;1726181;5209460;193300
2022;3;Niederösterreich;40860619;15074020;25786599;1138810
2022;4;Oberösterreich;25825562;6715197;19110365;719774
2022;5;Salzburg;11113083;3299623;7813460;309728
2022;6;Steiermark;22487336;6632705;15854631;626735
2022;7;Tirol;10189591;4444757;5744834;283990
2022;8;Vorarlberg;7289131;1650465;5638666;203152
2022;9;Wien;73075627;65407900;7667727;2036661
2022;10;Österreich;203650358;107188325;96462033;5675856
2022;1;Burgenland;5877226;2240892;3636334;163802
2022;2;Kärnten;6940494;1728219;5212275;193436
2022;3;Niederösterreich;40867069;15077986;25789083;1138989
2022;4;Oberösterreich;25831615;6716914;19114701;719942
2022;5;Salzburg;11115059;3300946;7814113;309783
2022;6;Steiermark;22494557;6637780;15856777;626937
2022;7;Tirol;10192503;4447669;5744834;284071
2022;8;Vorarlberg;7290884;1651040;5639844;203201
2022;9;Wien;73117964;65449975;7667989;2037841
2022;10;Österreich;203727371;107251421;96475950;5678002
2022;1;Burgenland;5880131;2243758;3636373;163883
2022;2;Kärnten;6941369;1729094;5212275;193460
2022;3;Niederösterreich;40873188;15081431;25791757;1139160
2022;4;Oberösterreich;25842765;6720009;19122756;720253
2022;5;Salzburg;11116638;3301868;7814770;309827
2022;6;Steiermark;22501452;6642700;15858752;627129
2022;7;Tirol;10194685;4449851;5744834;284132
2022;8;Vorarlberg;7292170;1651493;5640677;203237
2022;9;Wien;73164800;65496693;7668107;2039146
2022;10;Österreich;203807198;107316897;96490301;5680227
2022;1;Burgenland;5880131;2243758;3636373;163883
2022;2;Kärnten;6941369;1729094;5212275;193460
2022;3;Niederösterreich;40873188;15081431;25791757;1139160
2022;4;Oberösterreich;25842765;6720009;19122756;720253
2022;5;Salzburg;11116638;3301868;7814770;309827
2022;6;Steiermark;22501452;6642700;15858752;627129
2022;7;Tirol;10194685;4449851;5744834;284132
2022;8;Vorarlberg;7292170;1651493;5640677;203237
2022;9;Wien;73164800;65496693;7668107;2039146
2022;10;Österreich;203807198;107316897;96490301;5680227
2022;1;Burgenland;5880131;2243758;3636373;163883
2022;2;Kärnten;6941369;1729094;5212275;193460
2022;3;Niederösterreich;40873188;15081431;25791757;1139160
2022;4;Oberösterreich;25842765;6720009;19122756;720253
2022;5;Salzburg;11116638;3301868;7814770;309827
2022;6;Steiermark;22501452;6642700;15858752;627129
2022;7;Tirol;10194685;4449851;5744834;284132
2022;8;Vorarlberg;7292170;1651493;5640677;203237
2022;9;Wien;73164800;65496693;7668107;2039146
2022;10;Österreich;203807198;107316897;96490301;5680227
2022;1;Burgenland;5887443;2250229;3637214;164087
2022;2;Kärnten;6942778;1730252;5212526;193499
2022;3;Niederösterreich;40888560;15094085;25794475;1139588
2022;4;Oberösterreich;25852967;6725179;19127788;720537
2022;5;Salzburg;11119266;3303866;7815400;309901
2022;6;Steiermark;22511796;6651270;15860526;627417
2022;7;Tirol;10198592;4453758;5744834;284241
2022;8;Vorarlberg;7294121;1652546;5641575;203291
2022;9;Wien;73257152;65588256;7668896;2041720
2022;10;Österreich;203952675;107449441;96503234;5684281
2022;1;Burgenland;5890077;2252021;3638056;164160
2022;2;Kärnten;6947449;1731780;5215669;193630
2022;3;Niederösterreich;40895174;15098961;25796213;1139773
2022;4;Oberösterreich;25859786;6727126;19132660;720727
2022;5;Salzburg;11127856;3304890;7822966;310140
2022;6;Steiermark;22515339;6653515;15861824;627516
2022;7;Tirol;10201158;4456324;5744834;284312
2022;8;Vorarlberg;7295131;1652804;5642327;203320
2022;9;Wien;73308019;65638829;7669190;2043138
2022;10;Österreich;204039989;107516250;96523739;5686715
